gispropnum,q1,q2,q3,q4,budsum
X039,25665,23842,26961,55286,131754
R065,42089,23171,40915,26805,132980
X092,34802,49119,46262,61934,192117
M010,85164,127534,93191,119949,425838
Q099,151834,122130,226068,107411,607443
Q001,23413,16923,28293,25033,93662
B073,95910,158487,207705,143893,605995
Q015,58147,87003,62723,44576,252449
Q021,14789,10587,11808,21474,58658
Q162,21876,29641,9414,40193,101124
R031,3874,7871,4857,8064,24666
Q371,972,1593,33,1009,3607
R119,4747,9357,2611,1409,18124
M071,30599,32771,54558,27353,145281
M104,44713,78901,93924,69641,287179
R046,52640,20564,26532,112641,212377
R005,50024,54385,47251,21529,173189
R120,81,151,0,530,762
B057,19885,19801,14350,10833,64869
M042,14148,8083,5643,7863,35737
X002,45077,33423,54620,29660,162780
B169,71369,40946,28303,156601,297219
Q024,11580,14152,11524,11455,48711
R106,2355,5484,2770,4304,14913
Q020,6356,6354,11319,7857,31886
R006,6776,13270,35279,8973,64298
X010,27593,12057,15717,39130,94497
X118,3902,2148,2190,4808,13048
R022,9604,19792,40659,12198,82253
B018,5487,4437,24781,6304,41009
R079,0,587,276,958,1821
M107,1040,6438,2563,2998,13039
Q005,4661,5247,8705,10936,29549
M028,4442,2729,1357,3064,11592
M037,22136,7796,14641,52214,96787
B166D,1085,1393,900,1535,4913
B384,109,0,0,23,132
B125,5015,3782,2001,1567,12365
Q300,5627,5884,5153,4543,21207
X126,2138,1863,785,3834,8620
M029,15100,18551,3725,9461,46837
Q008,11661,4963,1917,2659,21200
B082,3757,4738,14316,10877,33688
X003,1752,405,127,646,2930
Q012,3548,11839,5771,5696,26854
X033,4676,3123,4708,3348,15855
Q102,13814,7045,6557,5633,33049
Q300A,1555,1254,1211,2888,6908
Q004,11387,8359,11777,66712,98235
B028,6683,4244,3492,2556,16975
X088,3049,2230,207,953,6439
M144,11820,11920,6432,8468,38640
B126,10227,4626,12416,36981,64250
Q452,50,1549,525,297,2421
Q007,3035,1774,814,2575,8198
X008,10527,5830,9317,23999,49673
Q448,15091,16429,12495,12578,56593
B068,16507,6582,7429,3097,33615
X045,6164,11499,2177,6392,26232
X046,497,1874,334,551,3256
B058,9777,15608,85911,48592,159888
B529,2920,3717,5260,11650,23547
Q010A,1053,3556,953,3491,9053
B065,2781,2320,7718,1903,14722
M056,7049,12051,7023,5823,31946
R016,5178,9368,1611,20034,36191
B251,2587,4768,16688,9113,33156
B032,3281,3743,11134,34652,52810
B129,3010,13104,6113,972,23199
X142,13,140,131,406,690
Q476,546,1777,826,920,4069
M077,4615,5844,8310,4466,23235
X030,5138,7721,5563,4143,22565
B087,7943,3569,4451,27901,43864
B066,4585,24125,1048,7759,37517
Q458,12069,22257,11951,23927,70204
Q107,2932,2084,148,1266,6430
R017,4103,6741,3022,4032,17898
R140,0,0,0,169,169
R121,29,0,0,223,252
B054,4894,2860,3003,1109,11866
M283,0,0,0,0,0
Q009,4722,4001,4687,973,14383
R169,24,700,209,0,933
B080,9442,3958,1686,1671,16757
R145,1921,836,167,320,3244
M005,1909,4179,2685,4723,13496
M058,5524,4212,6776,16337,32849
Q104,3854,5547,27258,5942,42601
X104,7013,2857,2296,3760,15926
B166C,118,92,419,658,1287
Q467,40,344,341,528,1253
B029,2275,806,759,2,3842
M053,503,579,168,1287,2537
B007,120708,46383,5008,3370,175469
Q461,2399,299,1091,3088,6877
X047,1404,799,3921,1979,8103
R048,0,0,0,0,0
Q126,1267,1151,696,2255,5369
B052,2744,3056,2943,4035,12778
R124,737,0,599,27,1363
Q412,2101,0,324,40,2465
B247,442,2439,3332,1011,7224
X034,5283,3963,5267,29415,43928
M353,4671,703,1634,1264,8272
R117,740,10768,4755,2422,18685
M047,1908,11326,2854,11416,27504
M300,233,297,253,966,1749
X136,1672,3507,1486,4934,11599
X010A,1092,990,1555,1751,5388
M081,16827,33366,25396,26699,102288
R059,404,397,14,363,1178
Q094,3109,1196,1221,2569,8095
R075A,0,310,432,29,771
Q084,233,0,125,189,547
M014,8119,3705,3816,30619,46259
Q028,134,0,28,0,162
Q392,369,917,0,1820,3106
X307,3447,817,1466,13945,19675
Q006,2602,1355,2276,2716,8949
X201,765,2426,2508,1995,7694
X344,1306,2805,2695,1244,8050
Q023,5202,3656,1315,1201,11374
Q445,504,778,841,0,2123
X044,3486,3743,5007,7728,19964
M043,453,176,72,443,1144
Q051,1752,3608,657,946,6963
Q094D,180,0,123,644,947
X268,45,0,0,89,134
M098,4538,6428,5125,9792,25883
B431,0,0,0,21,21
B008,11285,3794,904,27863,43846
R109,17281,3303,3440,77301,101325
M088,6249,7231,4178,4216,21874
B021,7496,4697,4333,22045,38571
B113A,2694,2940,1879,3138,10651
B214,1467,1023,2306,1320,6116
Q471,3993,1411,1095,7595,14094
X001A,583,1229,1025,1289,4126
M008,0,0,0,29,29
X191A,155,661,72,621,1509
B245,2243,5143,3154,2101,12641
X196,3401,4045,3863,40184,51493
R052,1765,2332,0,903,5000
Q052,178,859,166,962,2165
Q089B,1059,2169,1186,1713,6127
B114,1338,926,488,1378,4130
X080,730,3354,1129,1235,6448
Q131,216,713,28,393,1350
X007,0,414,249,650,1313
Q413,1881,5474,3316,515,11186
M013,3468,11496,2851,5968,23783
X147A,1167,1587,863,1411,5028
B379,25,975,44,0,1044
B210W,6298,4411,1155,930,12794
B077,4276,6079,222,1656,12233
B060,3440,4674,2845,2679,13638
Q048,695,697,32,856,2280
M105,20825,10580,9904,10437,51746
X019,0,1019,56,1613,2688
B088,223,28526,4119,1151,34019
B159,3397,769,387,1025,5578
X255,2028,1434,1198,2310,6970
Q121,3786,4659,2544,18006,28995
Q086,1859,3493,702,1718,7772
R038A,1815,824,284,1479,4402
M360,24796,35543,6493,3075,69907
B012,6859,9098,744,1676,18377
X028,2439,3040,909,1652,8040
B016,712,61227,593,2398,64930
M039,493,554,180,155,1382
B372,455,3218,1226,2273,7172
M099,12233,5437,2251,1982,21903
B329,1057,2215,113,3604,6989
B385,287,154,84,525,1050
X091,38,0,0,69,107
R075B,0,0,0,0,0
M089,6920,8822,4236,6679,26657
M208D,920,426,24,1637,3007
X305,16926,826,219,6488,24459
M186,1101,3944,4158,5313,14516
B025,660,2382,1167,2100,6309
B042,3961,3053,1247,2497,10758
Q220C,457,125,312,255,1149
B223K,136,116,69,77,398
B135,0,5,0,0,5
M052,1928,3970,1751,1648,9297
Q492,196,2225,948,3324,6693
X253,1364,283,956,709,3312
B141,1131,3001,562,4453,9147
Q387B,0,0,0,0,0
B192A,828,342,0,0,1170
B254,1932,1177,2801,1474,7384
M022,3120,2844,1888,2570,10422
Q004A,586,0,153,303,1042
B050,437,511,216,1837,3001
M094,506,203,833,452,1994
Q096B,244,664,85,1267,2260
X004,5986,1989,3815,3199,14989
X013,389,1024,6911,1093,9417
Q174A,1879,543,1543,936,4901
Q103,929,379,1063,4397,6768
Q305,1820,1362,1792,366,5340
B035,359,173,46,0,578
R015,2404,5514,5591,4677,18186
Q220G,914,525,617,6561,8617
R067,4269,2395,623,4597,11884
Q002,782,4876,14764,1639,22061
Q453,0,226,0,246,472
Q092,734,1141,222,9731,11828
B103,167,159,35,319,680
B100,1434,16740,4362,1366,23902
Q465,563,131,0,154,848
R045,5792,1518,814,2257,10381
X259,13,147,264,74,498
M376,2185,2764,1551,891,7391
Q339,1025,14223,207,1123,16578
Q127,2642,4179,2154,1234,10209
X038,3680,809,272,965,5726
Q226,2171,1571,1920,505,6167
B418,122,1286,175,216,1799
Q396,1642,536,503,1269,3950
X263,294,1105,483,766,2648
M017,3098,1812,5477,5573,15960
X137,154,102,360,14,630
Q129,187,152,429,6692,7460
R008,12262,1014,5775,43210,62261
B070,0,0,0,0,0
M033,7730,1248,3344,9202,21524
B113C,3844,1781,1676,1045,8346
R061,1838,1519,1574,8334,13265
M159,272,690,190,1441,2593
B055,958,1825,1863,5653,10299
X122,3387,254,162,899,4702
R078,224,484,58,675,1441
M086,4071,6581,1498,1554,13704
M011,5279,2536,2941,4487,15243
X150E,634,2144,654,544,3976
Q359,819,724,512,2008,4063
X271,527,484,445,4485,5941
M223,10153,926,708,836,12623
Q373,262,273,117,956,1608
Q391,285,750,409,1621,3065
X011,137,338,1386,338,2199
R075C,0,0,44,0,44
Q221,3002,244,550,171,3967
Q410,1215,507,2193,2586,6501
Q369,1427,1234,531,1935,5127
Q219,61,103,37,1564,1765
Q215,341,401,161,181,1084
Q329,479,587,14,256,1336
R072,28,103,71,249,451
B002,61,316,34,255,666
B218,1301,2523,359,1856,6039
X152,555,1099,335,545,2534
B244,1751,703,878,817,4149
R073,2733,616,442,535,4326
Q017,444,237,333,723,1737
R101,0,0,0,0,0
B051,668,260,1168,3980,6076
M108Q1,0,586,0,520,1106
Q134,1306,1022,376,1161,3865
X251,47,118,0,336,501
B275,6938,449,784,257,8428
B130,2474,3282,2556,688,9000
B225,834,1227,1216,46,3323
M082,689,3171,261,1642,5763
X166,1941,3281,934,1229,7385
X260,436,424,841,1673,3374
R026,887,3041,1232,1332,6492
Q302,1173,538,879,389,2979
M045,13979,1974,3630,12936,32519
X051,0,13,11,14,38
X124,1873,2886,1066,690,6515
R110,9064,233,2048,14716,26061
Q095,144,280,1586,651,2661
B219,822,572,1070,598,3062
Q336,0,1749,0,202,1951
M015,1460,3056,22627,4676,31819
R089,1432,351,1537,3703,7023
B109,6196,1055,1987,704,9942
X123,8410,1086,88,560,10144
B079,1198,1315,1852,4139,8504
B106A,379,893,741,1888,3901
R043,7909,370,4600,23346,36225
B217,7498,95,35,1290,8918
B432,1092,3206,76,117,4491
Q026,1380,4941,3376,5657,15354
M216,564,1209,773,1467,4013
B111,2306,1878,2962,10934,18080
B270,504,1334,281,465,2584
X020,219,465,214,638,1536
R011,142,583,0,344,1069
B250,1822,3004,477,1138,6441
Q031,1521,997,180,7794,10492
R068,0,103,0,671,774
B223NA,669,69,0,132,870
B324,177,788,369,28,1362
Q294,0,472,258,443,1173
B164,1519,1008,548,2100,5175
Q310,0,226,133,82,441
Q307,322,760,212,305,1599
Q096E,660,141,19,654,1474
B169B,872,1189,2470,543,5074
B380,4383,997,1464,328,7172
B113E,452,174,119,413,1158
R029,922,1181,0,2302,4405
B113D,0,0,0,0,0
Q351,2453,758,65,160,3436
Q360N,1701,697,1873,1373,5644
R076,690,1973,751,2786,6200
B163,8571,853,1743,3915,15082
B017,54,1908,116,1200,3278
Q085,2363,735,442,609,4149
B049,622,39,339,586,1586
Q333,1670,695,714,454,3533
M076,1900,2459,1488,2097,7944
B078,255,108,527,783,1673
B395,1165,103,387,126,1781
Q358,901,172,219,369,1661
Q387A,176,226,258,645,1305
B330,377,40,4,219,640
X193,7011,349,305,694,8359
X151,498,3890,406,1491,6285
M019,1476,2233,1039,557,5305
Q022,489,2584,870,2732,6675
X186,46,199,56,801,1102
Q364,2990,2637,312,5489,11428
Q082,922,1175,2895,641,5633
X165,1846,796,1203,1398,5243
B145,1392,705,8066,129957,140120
X187,298,464,366,475,1603
Q141,378,1424,10704,3377,15883
X252,786,496,395,316,1993
Q205A,787,1440,14,4811,7052
X015,2,625,120,46,793
Q301,284,14,400,346,1044
M164,2293,1443,396,6146,10278
M231,29,0,0,0,29
B285,1316,879,75,1081,3351
Q401,1860,526,679,2034,5099
Q218,602,671,7,1893,3173
B252,298,369,532,443,1642
B166B,746,102,1859,298,3005
X155,636,608,743,499,2486
R035,0,103,0,234,337
B269,0,124,0,0,124
Q299,326,19,0,166,511
X040,2647,5138,1630,958,10373
M165,3349,1344,1535,465,6693
B377,502,79,2,413,996
B291,263,95,125,308,791
B271,604,401,190,455,1650
M108F,0,0,672,205,877
R053,0,0,189,141,330
B056,679,427,223,6237,7566
B147,3,159,0,249,411
B224,734,540,1386,302,2962
B337,726,1567,399,2042,4734
B248,2146,1029,175,3877,7227
B153,179,192,80,453,904
Q320,290,1418,590,12062,14360
Q119,1019,3183,163,471,4836
R161,0,0,97,0,97
X108,750,908,10730,2925,15313
R025,1881,1243,2425,3354,8903
M095,0,102,85,0,187
B223I,368,0,0,0,368
Q014,62,105,76,1631,1874
Q066F,8557,649,0,1434,10640
X163,1471,715,1727,1268,5181
X262,97,62,14,104,277
M308,3562,2194,2618,1695,10069
X266,842,1877,772,995,4486
B223JB,284,980,2953,297,4514
B193,212,1380,549,1791,3932
Q382,0,0,0,392,392
Q386,822,349,115,374,1660
Q345,418,964,471,69,1922
B239,1226,238,76,1109,2649
X204,169,358,145,357,1029
Q388,137,17,0,129,283
M087,0,197,103,383,683
Q027,710,262,0,687,1659
Q327,1189,400,77,3853,5519
R070,836,0,0,0,836
R123,2976,434,1087,2618,7115
Q346,1941,167,411,580,3099
Q106,1658,1000,1834,971,5463
Q340,1726,689,1404,1876,5695
Q330,79,1592,28,187,1886
B038,66,386,801,695,1948
Q393H,0,0,0,0,0
B061,1445,30503,18078,9064,59090
Q361,994,368,811,2336,4509
B128,1736,813,376,1493,4418
Q398,1462,1016,650,898,4026
B263,0,212,56,104,372
Q293,1712,253,190,681,2836
M220,1863,1606,2623,5672,11764
X138,134,235,42,0,411
Q133A,45,0,0,0,45
B223JC,341,374,0,56,771
B382A,0,232,103,142,477
R069,2061,1459,261,1294,5075
Q303,1065,1215,496,1002,3778
X121,4809,488,692,5081,11070
B343,605,189,520,1082,2396
M031,46,7,0,77,130
Q394,0,56,1031,448,1535
B235,1061,4149,1883,359,7452
M030,3393,72,36,531,4032
X261,1778,3429,3893,1029,10129
X217,2323,977,406,1345,5051
B019,2067,3759,17124,3979,26929
X195A,342,52,236,300,930
Q128,434,438,2580,622,4074
B419,0,397,158,97,652
X153,852,254,1157,2053,4316
B210H,155,1529,307,1209,3200
X116,1610,352,663,2400,5025
B105,77,1225,227,77,1606
B381,117,1192,0,971,2280
X289,143,462,77,291,973
M009,1085,1415,1992,1722,6214
X111,475,831,792,2396,4494
Q030,0,569,282,88,939
B216,286,1123,600,1088,3097
X055,273,23,56,267,619
B228,1368,111,257,67,1803
Q108,256,493,0,740,1489
X179,20,33,26,522,601
Q474,131,129,250,1463,1973
R028,1447,617,89,508,2661
B296,839,280,161,1022,2302
B369,1003,1336,1777,483,4599
M194,7179,830,633,1169,9811
Q342,426,176,766,286,1654
Q393C,0,80,0,0,80
Q425,705,256,224,330,1515
M289,28,23,0,465,516
Q450,605,1210,834,8691,11340
Q363,1362,1450,1491,715,5018
B279,157,334,473,256,1220
B003,6245,4,0,0,6249
X239,189,0,0,0,189
Q031A,22,30,0,158,210
M004,139,541,62,860,1602
B401,93,168,269,328,858
M229,348,1382,172,2169,4071
Q306,275,612,206,492,1585
M205,226,92,169,211,698
B266,1335,220,494,1258,3307
R038,393,2267,367,483,3510
X081,164,176,111,39,490
B140,8,5,28,42,83
M038,1740,293,203,524,2760
Q268,280,0,56,0,336
X202,3157,1318,350,996,5821
B396,678,153,60,178,1069
B146,1463,650,61,882,3056
Q360J,11,1440,1159,2478,5088
B342,384,79,277,321,1061
X232,1155,449,1232,4081,6917
B294,2795,445,730,335,4305
Q393D,112,0,0,0,112
X172,1401,2242,231,437,4311
R097,0,83,15,111,209
R114,4398,2019,2387,1330,10134
B144,2,743,821,1460,3026
Q357B,3187,17659,1094,1558,23498
M263,285,3842,29,934,5090
M203C,1454,1682,1750,6581,11467
X157,426,1227,747,812,3212
B150,1000,2327,1017,1533,5877
M230,830,3241,93,2922,7086
X176,524,2235,642,484,3885
M283A,0,0,0,0,0
B403,1023,517,0,241,1781
Q460,115,66,1673,740,2594
Q390,729,282,936,1211,3158
B178,71,0,0,0,71
B237,564,861,281,269,1975
B111A,94,458,212,784,1548
Q098,1358,590,188,1129,3265
R063,3640,1460,1475,6504,13079
Q423,1906,2290,1448,4676,10320
Q335,867,500,363,344,2074
M226,1419,837,1273,1302,4831
R066,124,52,0,59,235
B210A,416,429,286,28,1159
X171,2666,379,715,1239,4999
B215,0,221,190,198,609
M270,3294,984,103,4737,9118
B243,525,143,479,65,1212
Q366,1183,545,0,117,1845
Q220F,560,28,115,5,708
B258,1582,844,148,119,2693
M187,5,333,504,184,1026
Q377,418,1080,122,133,1753
Q317,362,315,682,702,2061
Q343,250,214,2080,212,2756
Q347,992,363,437,315,2107
Q360M,169,802,49,345,1365
Q393A,25,184,0,354,563
B157,1084,1005,1408,11272,14769
M065,192,703,0,227,1122
X041,291,214,435,382,1322
M108T,29,201,701,289,1220
M200,362,171,112,646,1291
X185,384,125,0,266,775
Q334,76,1800,416,85,2377
X148H1,144,307,0,324,775
B364,3348,597,1579,1064,6588
Q443,305,77,123,494,999
R126,0,0,0,58,58
B236,1659,1139,1156,3708,7662
Q178,0,42,0,117,159
Q220B,77,26,76,253,432
M190,5361,1900,296,104165,111722
B335,48,1143,83,409,1683
Q207,899,1803,238,508,3448
B322,7,92,891,91,1081
X016,605,2050,693,877,4225
B249,469,366,514,119,1468
X095,575,16361,3564,1978,22478
B151,98,30,49,1355,1532
X103,1137,1392,1268,1117,4914
X219,778,872,858,1102,3610
B223A,245,676,609,545,2075
X233,301,281,0,282,864
Q105,1812,361,107,447,2727
R090,1668,1093,406,434,3601
B268,0,639,0,292,931
M079,580,2704,1241,72,4597
X177,145,933,69,354,1501
M208E,911,1617,0,52,2580
B223G,188,116,0,52,356
R111,207,2540,3298,420,6465
B127,2,79,104,361,546
Q220E,251,740,63,249,1303
B192,347,1183,1127,3610,6267
B223DA,3717,466,0,418,4601
X148H,268,217,650,303,1438
B044,111,60,2,159,332
B429,2,77,0,252,331
R034,294,465,0,188,947
Q314,933,473,374,140,1920
Q318,733,418,0,695,1846
B293,258,80,0,103,441
X284,265,636,603,612,2116
M245,726,216,2022,1030,3994
B284,1253,46,2503,286,4088
B360,169,544,1234,145,2092
M095A,1,29,85,5,120
X169,0,278,162,2,442
Q378,570,560,233,230,1593
X029,30,73,723,154,980
B110,958,591,0,98,1647
B262,1492,933,871,394,3690
R019,1261,205,172,485,2123
M094A,0,24,0,0,24
B255F,0,145,83,162,390
Q053,2072,251,718,214,3255
Q298,54,103,147,2026,2330
R105,404,425,255,1353,2437
Q379,83,892,0,143,1118
B232,2516,10362,163,2077,15118
Q428,481,638,707,1118,2944
Q021C,50,589,28,67,734
Q066B,3667,970,821,2008,7466
B310,3610,302,1388,31175,36475
R087,1475,1469,1817,2328,7089
M258,847,834,1059,508,3248
M132,8649,780,142,640,10211
X101A,14,0,0,86,100
X150J,3841,542,1026,878,6287
Q308,386,37,0,0,423
M059,116,322,132,141,711
B131,0,88,646,315,1049
X221,709,576,209,454,1948
Q348,632,1198,512,1442,3784
X150I,154,67,47,0,268
Q344,1893,309,33,128,2363
M225,162,538,10,633,1343
B302,13,39,75,116,243
B301,214,189,596,1172,2171
X256,10,0,0,72,82
B253,3581,9090,2720,1643,17034
Q362,942,2699,29,698,4368
M206,354,429,131,252,1166
B267,194,202,934,775,2105
M003,146,57,424,2813,3440
B210I,499,271,750,276,1796
Q353,0,0,1368,284,1652
B139,1906,1154,418,869,4347
B331,105,93,271,30,499
M070,0,52,1704,0,1756
B169A,508,504,160,4292,5464
Q066H,828,263,0,0,1091
Q223,0,206,69,20,295
M217,5398,490,185,351,6424
B282,1942,35,807,222,3006
X141,1280,607,927,959,3773
B264,741,826,1973,196,3736
M192,20682,493,490,234,21899
X168,1479,851,992,1344,4666
Q389,587,172,170,60,989
B274,2193,265,145,586,3189
B359,3204,23561,212,435,27412
Q381,202,392,376,169,1139
X214,176,272,180,413,1041
Q437,56,26,1545,205,1832
X190,595,733,620,2086,4034
X147B,1946,283,359,387,2975
B323,358,60,283,611,1312
Q440,2399,0,118,0,2517
B113B,111,775,32,566,1484
Q337,260,144,402,165,971
X235,900,712,305,427,2344
B106B,46,403,179,163,791
B407,0,77,141,375,593
B350,96,299,0,0,395
B234,558,646,417,1747,3368
B259,359,89,433,679,1560
Q400,101,342,976,855,2274
B221,0,39,158,109,306
B124,740,494,125,736,2095
B349,2685,1734,56,243,4718
B026,827,219,162,418,1626
Q304,2240,416,646,443,3745
Q352,614,163,83,381,1241
Q066G,0,0,736,0,736
B378,125,0,0,9,134
Q290,205,1558,0,2453,4216
R064,12000,33397,223,1629,47249
Q404,394,931,125,227,1677
Q118,4437,142,572,3570,8721
B152,3347,399,401,888,5035
Q375,123,857,367,119,1466
M237,1266,96,5,7,1374
Q011,113,760,338,447,1658
Q422,299,1874,125,777,3075
R144,0,72,0,0,72
M273,2235,439,238,1988,4900
B210B,504,249,267,499,1519
B376,108,2336,60,422,2926
Q266,42,125,285,162,614
R085,507,727,987,1693,3914
R125,115,670,427,51,1263
X025,219,0,132,39,390
B358,3188,210,151,212,3761
B387,29,500,827,149,1505
B022,635,182,0,968,1785
X188,3119,1064,489,526,5198
B223DK,1390,471,2,238,2101
B382B,0,0,118,54,172
Q415,270,1119,557,448,2394
M158,628,895,982,204,2709
B298,0,0,0,4846,4846
Q100,0,61,0,28,89
Q402,790,249,83,294,1416
R071,606,334,0,741,1681
B272,1223,411,0,0,1634
Q426,410,236,663,429,1738
B346,1772,669,241,0,2682
B334,157,142,142,8099,8540
B197,8311,1177,592,2508,12588
Q349,7728,1276,439,294,9737
Q403,115,1233,0,39,1387
X183,79,282,74,172,607
M111,0,82,995,587,1664
Q044,715,429,4707,3862,9713
X131,2057,628,439,90,3214
X182,616,3537,996,751,5900
M108G,0,4,0,103,107
Q414,796,1557,0,882,3235
X158,385,239,282,186,1092
Q406,163,275,331,2888,3657
B325,5954,95,255,190,6494
B230,1487,4522,419,849,7277
Q393I,204,0,28,0,232
B286,9418,313,282,285,10298
X156,325,420,172,1280,2197
B132,112,66,246,715,1139
Q367,4740,315,366,835,6256
B295,104,189,71,86,450
Q430,252,153,0,299,704
Q321,453,234,0,409,1096
Q332,3319,465,104,404,4292
M007,0,274,58,4511,4843
R042,103,229,0,207,539
X178,297,669,1537,2576,5079
B156,54,147,57,460,718
X288,77,134,102,27,340
Q319,690,554,519,990,2753
B142,553,436,359,473,1821
Q328,172,147,296,386,1001
M214,0,111,105,0,216
X160,166,1543,71,844,2624
B362,2361,89,0,211,2661
B352,283,163,429,570,1445
X110A,0,0,0,0,0
B260,2446,858,271,13082,16657
B357,3345,127,569,492,4533
M198,0,26,1144,3935,5105
X154,235,234,171,23,663
M199,541,776,145,1848,3310
B309,3547,726,35,312,4620
X159,7556,536,104,1252,9448
X148A2,28,378,642,321,1369
X203,753,202,581,346,1882
M294,358,318,1472,1996,4144
B311,0,5,11,119,135
M193,1533,802,1507,2228,6070
Q313,1940,60,135,0,2135
X194,139,254,393,207,993
M242,9,397,48,815,1269
X222,738,841,172,1435,3186
Q405,1535,187,328,260,2310
Q211,192,199,866,281,1538
X115,784,1999,1723,1051,5557
X273,2530,356,327,227,3440
Q407,682,571,417,1080,2750
M213,443,154,134,385,1116
X272,81,150,88,522,841
X087,11763,599,3567,886,16815
B287,8036,58,28,116,8238
B347,798,9468,436,246,10948
B320,1195,1948,656,1375,5174
M215,665,878,419,419,2381
B223IA,0,0,0,0,0
R086,182,258,0,310,750
M233,139,467,574,412,1592
X021,560,92,249,1560,2461
X247,648,572,379,583,2182
M183,7985,305,101,86,8477
Q427,464,241,21,775,1501
Q421,292,184,0,221,697
Q436,1562,699,380,1035,3676
B277,867,767,486,286,2406
B353,0,0,5,0,5
B102,1627,574,1705,821,4727
B255K,42,74,176,111,403
B315,781,860,542,465,2648
B307,108,413,52,891,1464
R009,0,0,29,27,56
B361,366,117,49,350,882
B397,102,78,292,128,600
Q385,2111,824,1104,575,4614
B321,471,4640,256,196,5563
B223E,3,0,42,0,45
B340,216,52,31,7694,7993
B363,320,93,297,126,836
B367,458,92,0,58,608
B339,264,112,517,422,1315
B292,436,1496,7046,1615,10593
X238,0,0,0,0,0
X148L1,79,1109,0,124,1312
R012,902,1271,334,258,2765
R027A,1551,77,114,553,2295
Q399,1645,2068,1422,339,5474
B098,527,583,28,77,1215
X207,256,1522,268,110,2156
X085,708,1490,481,1115,3794
B348,469,534,155,184,1342
M108P,0,1042,327,158,1527
B001,74,1064,4636,445,6219
X243,224,39,37,161,461
Q067A,2883,1799,830,750,6262
Q025,0,0,0,0,0
Q291,257,242,14,464,977
B220,245,511,981,323,2060
R062,736,671,882,81,2370
B313,66,452,297,274,1089
Q289,90,28,0,139,257
M235,99,600,0,135,834
M208A,1847,871,1226,1194,5138
M035,0,383,15,110,508
Q408,327,251,503,281,1362
Q212,927,494,47,99,1567
Q357B01,1550,459,28,1120,3157
B332,4,53,452,633,1142
B107,79,73,1664,156,1972
B099,442,265,535,0,1242
B306,1824,592,501,629,3546
X017,1391,2375,968,1284,6018
R127,0,0,0,0,0
M241,46,113,0,430,589
B536,66,2083,4,380,2533
B261,139,4411,452,655,5657
X208,21,28,65,0,114
Q357I,0,42,92,0,134
M244,1791,358,466,251,2866
B316,0,284,0,878,1162
M321,7,42,0,5,54
Q357J,21,69,135,89,314
M239,581,1479,615,997,3672
X211,79,44,271,337,731
Q028A,612,561,392,238,1803
X146,6429,570,628,441,8068
Q419,1324,26,173,749,2272
X120,585,153,705,287,1730
X162,2751,2156,321,779,6007
M041,2328,509,1106,4735,8678
Q322,532,468,2756,83,3839
Q395,43,171,80,419,713
B345,29,198,38,805,1070
M243,0,52,138,155,345
B304,1416,2894,2307,603,7220
R107,0,0,0,0,0
M236,2971,606,1933,592,6102
Q429,1059,229,589,375,2252
X206,6310,170,0,3120,9600
B167A,35,35,14,218,302
R032,0,0,0,0,0
M054,0,202,29,261,492
M204,0,147,136,555,838
Q338,889,179,85,369,1522
M124,61,1542,29,208,1840
X105,673,598,1575,335,3181
Q037,0,564,313,0,877
X348,617,377,181,409,1584
B223R,50,860,643,1030,2583
Q354,94,285,2913,406,3698
X042,4254,636,253,290,5433
M184,29,52,301,1209,1591
B257,621,111,579,169,1480
B255E,0,4,111,42,157
R095,0,0,0,0,0
B210J,2495,918,1086,487,4986
X059,230,75,59,56,420
M219,1510,197,2938,1076,5721
X082,22,0,0,0,22
X174,4688,393,454,1356,6891
Q205B,3860,59,56,419,4394
R083,0,0,0,29,29
X032,867,35,157,319,1378
M046,0,126,29,4,159
M238,421,9794,1156,466,11837
R165,0,0,29,0,29
X200,1476,828,633,391,3328
X161,7774,644,199,487,9104
X113,306,314,78,915,1613
X265,939,542,457,713,2651
X228,34,37,92,0,163
B317,172,13,0,768,953
B149B,40,5,252,35,332
B255C,265,0,0,7,272
X106,282,241,15,408,946
X257,689,376,69,362,1496
Q041,735,1480,1712,843,4770
B300,217,398,394,409,1418
Q416,0,0,28,0,28
Q397,310,616,594,444,1964
M160,7999,1269,996,887,11151
M063,3105,5488,3955,2789,15337
B246,312,72,74,160,618
B288,647,1287,194,1164,3292
B283,552,94,104,336,1086
X164,3536,1998,252,325,6111
M064,112,550,12,107,781
M148,635,52,79,1038,1804
M379,29,619,0,142,790
B173,40,40,0,60,140
M211A,141,50,471,575,1237
M240,600,1375,292,219,2486
Q457,249,102,0,116,467
M211B,43,2257,601,1392,4293
X170,1432,1058,382,522,3394
M286,563,497,292,103,1455
B162,47,298,288,936,1569
M155,6496,102,411,227,7236
R100,56,0,0,153,209
X053,0,30,0,113,143
X175,410,829,266,456,1961
M069,1696,573,3131,3864,9264
X148A3,71,273,297,287,928
B223F,0,0,0,0,0
Q013,107,595,103,130,935
Q376,0,0,0,235,235
X258,116,646,154,62,978
B149A,21,33,49,6,109
M108Q,2620,1443,915,270,5248
X295,192,400,967,43,1602
M228,127,464,0,189,780
M120A,0,26,29,19,74
M285,1314,827,76,131,2348
M249,203,45,74,2280,2602
B326,2002,396,111,319,2828
B402,2451,79,35,300,2865
M108N,380,18,530,52,980
B161,208,295,218,775,1496
Q120,1394,370,87,273,2124
M277,1217,406,79,407,2109
B207,1158,792,197,169,2316
Q444,0,859,0,298,1157
M234,676,747,398,536,2357
Q038,292,52,3291,222,3857
Q225,0,0,0,0,0
M018,0,232,164,591,987
X269,276,74,407,80,837
B209,1209,923,403,742,3277
B223S,339,215,58,84,696
B137,261,348,569,305,1483
M259,24,372,10,2039,2445
Q262,0,0,0,0,0
Q326,45,107,0,236,388
X102,1547,1732,409,1234,4922
B095,229,412,111,212,964
M395,0,10,23,34,67
M221,0,256,0,103,359
X299,46,0,0,0,46
Q035,83,0,0,0,83
R099,0,0,14,0,14
B208,154,153,0,154,461
B297,84,1651,504,545,2784
Q122,759,402,563,368,2092
B312,794,1031,158,97,2080
X216,554,495,244,80,1373
B168,0,94,164,77,335
M066,320,217,822,1047,2406
M201,328,90,35,282,735
Q045,72,383,0,644,1099
M200A,1502,114,348,1107,3071
X148M,55,0,36,301,392
B223B,466,780,575,457,2278
B023,0,59,114,344,517
X280,62,219,620,173,1074
Q133,655,77,0,47,779
X110D,0,454,98,75,627
B405,39,39,0,26,104
B043,743,1524,3100,1242,6609
X110C,0,84,83,0,167
X110B,0,0,0,0,0
B222,464,1486,1106,1647,4703
Q285,90,0,139,0,229
B223IB,0,0,0,24,24
X086,0,26,0,39,65
M257,19,302,217,918,1456
Q267,0,155,0,826,981
R033,383,0,0,1812,2195
B166E,0,0,0,0,0
B255H,59,19,0,36,114
B255L,0,56,0,7387,7443
M171,2527,592,0,132,3251
X112,230,283,254,748,1515
M154,1,0,52,7643,7696
B063,30,39,0,66,135
Q357G,277,26,0,212,515
X148H2,1331,946,9,215,2501
B390,188,21,69,44,322
Q034,19,0,0,0,19
Q463,0,0,9,0,9
Q393E,45,0,0,0,45
B265,505,660,1114,240,2519
B386,0,0,129,0,129
Q066C,38,40,56,0,134
Q451,31,0,0,410,441
X148L,148,385,1671,326,2530
M110,165,52,270,248,735
M116,29,199,35,118,381
M279,48,1857,612,0,2517
R021,0,0,0,0,0
M295,0,76,0,260,336
Q101,1118,164,46,225,1553
M280,0,52,0,181,233
B255G,219,351,0,0,570
X150H,22,0,0,42,64
B158,1901,1551,427,1023,4902
X148M1,284,469,230,147,1130
M161,806,189,203,1246,2444
X292,1305,606,208,168,2287
M196,39,414,21,107,581
M355,5614,327,42,333,6316
B308,169,422,84,463,1138
X073,0,0,82,42,124
B210F,28,56,0,0,84
X014,632,206,699,1087,2624
X336,354,482,237,349,1422
X009,256,645,310,346,1557
M203B,355,2931,0,50,3336
R024,0,1002,0,179,1181
M203E,406,130,188,735,1459
M125C,29,814,40,226,1109
B167,225,212,4804,569,5810
R037,22,188,182,290,682
X197,1193,2067,278,547,4085
M096,0,886,245,0,1131
Q283,0,0,0,0,0
Q447,167,89,56,23,335
M113,369,190,5,196,760
Q046,482,871,258,293,1904
M264,515,158,131,173,977
X093,332,93,349,391,1165
R050,0,0,0,0,0
M386,26,883,1703,1371,3983
X149,70,96,0,0,166
B223OC,212,283,70,28,593
X084,0,191,164,0,355
X114,378,493,488,209,1568
X244,231,396,124,778,1529
X026,14,26,56,570,666
M404,166,0,0,0,166
M080,15,39,0,0,54
Q341D,0,0,0,0,0
M145,0,775,12,1214,2001
B223PB,0,39,212,39,290
B118B,0,5,0,438,443
M251,501,272,1837,943,3553
X148C3,915,173,90,125,1303
M255,0,575,10,1406,1991
B223OB,54,28,0,0,82
Q021B,0,103,61,103,267
B255J,81,39,0,108,228
M166,5,284,90,58,437
M208G,0,0,654,0,654
X148C7,31,405,8,278,722
Q393G,985,0,0,0,985
M156,0,0,134,0,134
Q341C,0,52,56,150,258
B118A,0,32,0,56,88
X150L,182,132,88,191,593
M265,187,131,0,105,423
M055,0,267,12,52,331
X286,279,645,49,652,1625
X291,100,120,583,0,803
B154,0,66,86,634,786
Q370,107,26,28,215,376
M256,1317,481,686,217,2701
B097,276,387,0,133,796
X180,0,13,0,77,90
X205,162,333,42,129,666
Q360U,0,0,0,0,0
B212,36,44,28,129,237
Q096A,399,469,77,336,1281
Q434,1425,103,0,77,1605
Q047,233,134,0,46,413
B223PC,609,1330,167,0,2106
X281,0,44,238,135,417
M006,0,158,377,103,638
X068,321,210,147,244,922
X139,9,0,0,0,9
B233,0,0,0,0,0
R080,358,423,163,132,1076
Q222,0,0,0,56,56
B223H,3,116,187,169,475
X224,56,77,18,739,890
B093,3,0,0,125,128
B121,173,264,0,214,651
B200,0,77,21,87,185
X148C5,468,540,277,165,1450
X058,448,78,396,63,985
Q136,703,0,0,0,703
B223PE,4989,0,363,39,5391
X057,38,14,48,13,113
X274,48,0,0,56,104
B255D,0,0,0,240,240
X150G,0,0,0,0,0
R010,264,0,0,0,264
B210G,0,0,0,0,0
Q003,0,0,42,0,42
X283,150,293,634,86,1163
M218,96,17,0,226,339
M208F,0,52,0,396,448
Q133B,0,52,45,52,149
R036,29,697,753,22,1501
M101,0,0,52,0,52
X242,26,61,56,119,262
B184,0,5,0,0,5
B210P,71,71,28,659,829
M178,0,269,10,133,412
M302,0,52,202,77,331
M191,1153,693,0,1327,3173
Q065,2169,1380,19,1715,5283
Q424,0,14,0,190,204
Q393F,0,0,0,0,0
Q073,0,52,0,81,133
M195,84,84,0,115,283
Q040,546,0,0,0,546
M246,0,579,14,36,629
B223PA,0,94,0,77,171
BT16,193,397,83,1163,1836
M292,54,16,117,52,239
M060C,391,0,0,181,572
Q456,1361,77,479,99,2016
M044,10,397,198,159,764
X037,0,0,0,0,0
X287,151,571,537,82,1341
B305,168,163,448,403,1182
M301,446,153,838,9,1446
B389,236,0,44,0,280
Q029,112,278,90,934,1414
M001,5,586,15,185,791
M027,1229,5182,558,205,7174
Q296,13,28,167,67,275
X043,38,0,0,0,38
Q284,61,0,0,28,89
Q246,20,0,0,0,20
Q123,406,21,0,542,969
X006,84,74,0,0,158
B375,239,642,150,0,1031
B223NB,31,150,8,99,288
X300,101,139,28,275,543
M385,115,678,58,758,1609
R020,611,0,0,29,640
X148C1,150,214,4,278,646
B036,0,764,28,0,792
Q151,0,0,0,0,0
M036,0,0,0,0,0
Q217,0,26,0,52,78
M125B,29,186,40,128,383
B227,26,0,0,0,26
B255M,88,81,0,137,306
B148,70,558,354,1910,2892
Q061,251,0,0,134,385
B116,0,186,0,0,186
X022,119,187,806,249,1361
M208C,0,103,48,300,451
B223QB,0,0,0,83,83
B206,8312,5,65,133,8515
Q084B,0,0,0,0,0
X302,120,174,42,187,523
Q316,0,0,0,45,45
M012,57,394,0,90,541
B182,0,0,0,0,0
Q281,0,0,0,0,0
M123,24,42,0,20,86
B223PD,28,0,0,90,118
X282,74,636,0,421,1131
Q360G,0,134,0,107,241
X148K3,0,0,160,14,174
X267,11,135,0,264,410
B223NC,50,696,0,52,798
Q084A,617,0,0,0,617
M138,56,145,28,100,329
X064,1805,19,186,72,2082
M016,190,445,621,126,1382
Q139,40,0,0,0,40
X077,152,0,28,144,324
X264,2,376,49,14,441
M288,19,115,58,265,457
Q360Q,52,0,167,0,219
M188,50,5,10,15,80
R004,2125,52,0,146,2323
X018,10,0,46,11,67
Q494,0,976,0,0,976
Q360E,0,0,0,212,212
B430,0,77,59,142,278
M180,1320,461,49,349,2179
X063,30,107,29,62,228
B356,46,50,207,105,408
Q275,0,0,0,22,22
M378,183,282,32,983,1480
B240,54,119,0,40,213
B190,59,28,0,0,87
X005,71,465,127,42,705
M207,0,23,289,627,939
X148D1,135,47,34,267,483
B024,0,0,0,0,0
Q277,14,0,0,0,14
B030,0,0,0,0,0
M122,15,174,10,92,291
M020,98,49,74,109,330
B366,0,383,14,14,411
M032,29,102,0,0,131
X107,0,152,0,230,382
Q209,10,0,0,0,10
B171,28,28,0,0,56
X079,126,37,13,0,176
B223QC,2,28,0,7,37
Q116,45,0,40,0,85
X148K4,0,0,30,49,79
X148E,13,229,90,192,524
B090,0,21,14,23,58
X148K2,0,0,125,0,125
Q177,0,0,0,0,0
Q435,0,0,0,0,0
M284,58,81,0,90,229
X023,52,101,44,0,197
M222,0,86,0,162,248
B391,538,624,0,125,1287
Q043,0,0,0,0,0
Q360F,0,89,0,0,89
X071,10,0,13,77,100
M303,0,0,0,0,0
X248,4659,194,0,3718,8571
X129,77,173,241,0,491
M025,0,0,0,959,959
X078,0,56,0,471,527
X067,130,47,236,11,424
X031,0,0,0,0,0
B255N,56,0,0,0,56
X096,19,138,33,0,190
M067,21,283,0,127,431
M224,0,5,0,15,20
M212,2856,1225,33,4,4118
M304,0,103,0,17,120
B273,0,0,0,0,0
X119,177,110,45,28,360
R049,0,0,0,0,0
M023,207,213,0,79,499
B404,226,210,0,344,780
Q325,0,0,28,0,28
X070,30,0,62,15,107
B089,0,0,0,0,0
B290,0,28,0,0,28
X062,0,26,43,0,69
Q491,0,4,0,0,4
Q059,0,77,0,2637,2714
Q137,0,98,0,0,98
Q483,223,0,94,14,331
M254,0,5,0,20,25
B194,5,0,3367,0,3372
X069,0,0,0,0,0
B223QA,42,0,140,0,182
X334,0,197,0,35,232
B226,0,0,28,14,42
X036,0,0,73,45,118
B191,662,18,0,34,714
Q036A,0,270,0,103,373
Q231,0,194,2038,0,2232
M203A,20,20,20,141,201
M097,209,147,100,150,606
Q055,0,0,0,0,0
Q259,0,0,0,0,0
X065,0,0,0,0,0
M002,0,10,0,25,35
X130,0,67,167,0,234
X012,0,0,0,0,0
Q341F,243,288,0,77,608
Q033,0,0,14,0,14
M061,0,0,0,0,0
X049,113,0,0,0,113
Q360R,0,0,0,0,0
Q080,0,0,0,38,38
X110,0,52,69,0,121
M127,0,0,0,0,0
Q190,0,0,0,45,45
B289,0,0,0,0,0
M093,0,0,0,0,0
Q018,42,0,0,0,42
M125D,0,77,0,52,129
M120B,129,1438,12,39,1618
B176,0,0,0,0,0
M021,0,200,39,10,249
B223MA,0,125,0,0,125
B223V,0,0,0,0,0
B115,0,0,0,0,0
B223T,0,0,0,0,0
X061,13,14,0,0,27
B388,3,5,2,289,299
M034,0,0,0,0,0
Q186,0,0,0,0,0
Q208,0,0,0,0,0
B062,4,4,0,44,52
Q360H,0,0,0,0,0
Q067,26,0,19,417,462
Q439,56,0,0,0,56
Q360S,0,0,0,0,0
M189,0,50,0,0,50
M287,0,0,0,536,536
M083,0,10,0,0,10
M085,147,371,39,88,645
X101,11,0,1186,0,1197
Q341E,0,888,0,52,940
Q203,0,0,436,0,436
Q090,0,0,0,0,0
B213,0,0,0,0,0
B160,0,0,0,0,0
Q214,387,0,0,0,387
B392,79,0,0,46,125
Q135A,0,0,0,56,56
M125A,0,107,30,52,189
X056,0,14,0,0,14
X148K1,0,0,0,0,0
B255O,0,0,0,0,0
B174,0,0,0,0,0
X060,0,0,0,15,15
Q355,43,28,73,0,144
Q254,0,0,0,0,0
Q140,20,0,0,216,236
Q224,0,0,0,0,0
B205,0,0,0,0,0
Q206,0,0,0,0,0
Q220D,0,0,85,130,215
B211,0,0,0,0,0
Q076,89,0,0,0,89
Q257,0,36,0,0,36
B242,0,0,111,0,111
M170,771,103,0,103,977
R002,0,0,0,0,0
Q042,349,0,0,308,657
M051,253,74,0,0,327
Q147,0,0,0,0,0
Q360T,0,0,0,56,56
X052,0,0,0,0,0
M125E,56,0,0,116,172
M024,29,0,0,10,39
B117,0,516,76,125,717
Q462,656,65,0,68,789
M172,0,620,0,17,637
Q243,0,0,0,21,21
X148B2,15,15,111,0,141
B196,0,0,0,0,0
M282,0,0,0,78,78
Q057,203,465,156,605,1429
M247,0,30,0,48,78
B126A,76,0,0,0,76
X148J2,0,83,328,31,442
B210C,52,97,56,0,205
R060,0,0,0,0,0
Q159,0,0,0,0,0
Q062,0,0,97,0,97
B172,0,0,0,0,0
B045,0,0,21,16,37
Q152,0,0,0,0,0
Q341B,0,0,0,0,0
Q383,0,0,0,0,0
Q160,228,0,0,208,436
M108H,0,0,0,0,0
X148I3,0,0,0,0,0
M169,0,0,0,0,0
B338,0,0,0,121,121
Q070,0,80,87,125,292
B027,0,0,0,0,0
X278,98,0,0,0,98
X133,0,0,0,0,0
B033,0,83,0,0,83
X134,0,0,28,56,84
B041,0,0,0,0,0
Q245,0,0,0,0,0
M040,0,0,0,0,0
M090,0,0,0,5,5
B202,0,0,0,0,0
Q157,0,0,0,0,0
Q060,83,0,108,0,191
B231,0,0,0,0,0
Q213,45,0,0,0,45
B229,0,0,0,0,0
B155,0,0,0,0,0
M108T01,63,592,29,35,719
Q135,0,0,42,0,42
M188A,26,0,0,3,29
B123,3,0,0,0,3
Q168,0,0,0,0,0
Q173,243,0,114,0,357
X001B,0,0,0,0,0
B006,0,0,0,9,9
Q148,295,0,111,0,406
Q387D,0,0,0,0,0
Q056,0,0,0,0,0
B175,0,0,0,0,0
B031,0,0,0,0,0
Q019,0,14,122,0,136
Q075,0,0,0,52,52
Q142,0,0,0,0,0
Q032,0,69,0,52,121
Q124,0,0,0,194,194
B278,0,0,0,0,0
Q072,0,0,0,0,0
Q068,87,65,0,34,186
Q079,202,0,0,0,202
B166,266,1430,0,0,1696
B544,0,0,0,0,0
M397,5,0,0,0,5
M382,0,0,0,0,0
M331,0,0,0,0,0
M296,0,77,0,77,154
X277,0,0,0,0,0
M177,0,0,0,349,349
X324,0,0,0,0,0
B535,0,0,0,0,0
X360,38125,44040,41138,41481,164784
M313A,5,77,0,35,117
B553,0,0,0,0,0
M313,5,0,0,0,5
M293,5,39,0,77,121
B438,0,0,0,0,0
X351,0,0,0,0,0
Q495,0,0,0,0,0
M312,5,39,0,35,79
B507,0,0,0,0,0
X350,0,0,0,0,0
Q470,0,387,0,103,490
B336,870,757,54,514,2195
B439,0,0,0,0,0
M372,5,0,0,0,5
B440,0,0,0,0,0
B441,0,0,0,0,0
X339,0,0,0,0,0
X001,45,0,0,35,80
R133,0,0,0,0,0
B443,0,0,0,0,0
Q486,0,0,0,0,0
R003,0,52,0,52,104
Q499,0,0,0,0,0
Q387E,0,0,0,0,0
R137,0,0,0,0,0
B555,0,0,0,43,43
Q096,25,0,0,0,25
M091,0,0,0,0,0
B444,0,0,0,0,0
B446,0,0,0,279,279
Q487,0,0,0,0,0
M333,0,0,0,0,0
R075G,0,0,0,0,0
Q464,0,0,0,0,0
X094,649,90,46,56,841
M334,5,0,0,0,5
Q478,0,0,0,0,0
X246,0,1196,0,0,1196
R172,0,0,4676,11591,16267
B256,0,0,0,0,0
B421,0,0,0,0,0
B422,0,66,0,103,169
B010,0,0,0,0,0
B223DD,0,0,0,0,0
B223DE,0,729,0,0,729
B223DF,0,0,0,0,0
B223DG,0,0,0,9,9
B223DJ,0,0,0,0,0
B048,0,0,0,0,0
B566,0,0,0,0,0
B554,0,0,0,0,0
X315,0,0,0,0,0
B561,0,0,0,0,0
R132,0,0,0,0,0
M359,5,0,0,0,5
R152,0,0,0,76,76
M388,0,0,0,0,0
B447,0,0,0,0,0
B448,0,0,0,0,0
X363,0,0,0,0,0
M374,0,0,0,0,0
B568,0,0,0,0,0
M402,0,0,0,0,0
M260,408,0,894,0,1302
M113A,0,5,0,0,5
M396,5,5,0,0,10
B224A,0,0,0,0,0
X279,0,0,0,0,0
B450,0,0,0,0,0
X321,0,0,0,0,0
Q010,0,56,0,0,56
B451,0,0,0,0,0
M281,0,26,0,52,78
X358,0,0,0,0,0
M305,0,0,0,0,0
M342,986,0,0,0,986
B526,0,0,0,0,0
M335,5,0,0,0,5
B520,0,0,0,0,0
B452,0,0,0,0,0
B453,0,0,0,0,0
B454,0,0,0,0,0
Q172,87,0,0,0,87
Q474A,0,0,0,0,0
X338,0,0,0,0,0
R135,0,0,0,0,0
B455,0,0,0,0,0
X340,0,0,0,0,0
Q505,0,0,0,0,0
B569,0,0,0,0,0
X326,0,0,0,0,0
X343,0,0,0,0,0
M336,5,39,0,35,79
M323,0,0,0,0,0
M337,5,0,0,0,5
M398,0,0,0,0,0
Q411,0,0,0,0,0
Q459,0,0,0,0,0
Q058,363,296,123,0,782
Q232,0,0,131,114,245
M026,2996,2038,1265,1513,7812
B414,0,88,0,19,107
B571,0,0,0,0,0
M208B,96,97,0,155,348
M324,5,39,0,35,79
B424,0,0,0,40,40
B458,0,0,0,0,0
B543,0,0,0,0,0
B459,0,0,0,0,0
M327,0,0,0,0,0
M319B,0,0,0,0,0
Q484,0,0,0,0,0
X341,0,0,0,0,0
X313,0,0,0,79,79
X323,0,0,0,0,0
X233A,0,113,0,52,165
M392,0,0,0,0,0
B577,0,0,0,0,0
M268,0,26,0,0,26
M339,5,0,0,0,5
M340,0,0,0,0,0
B460,0,0,0,0,0
B461,0,0,0,0,0
R153,0,0,0,0,0
B462,0,0,0,0,0
M330,0,0,0,0,0
X352,0,0,0,0,0
B463,0,0,0,0,0
B464,0,0,0,0,0
X312,0,0,0,0,0
M310,5,0,0,0,5
B465,0,0,0,0,0
M358,5,0,0,0,5
B466,0,0,0,0,0
M291,0,0,0,0,0
Q441,4240,2957,4251,87686,99134
B467,0,0,0,0,0
X359,0,0,0,0,0
R158,29,0,0,0,29
B394,0,0,0,0,0
M317,0,0,0,0,0
X318,0,0,0,0,0
B037,0,0,0,0,0
B530,0,0,0,0,0
B531,0,0,0,0,0
B532,0,0,0,0,0
B533,0,0,0,0,0
B545,0,0,0,0,0
B549,0,0,0,0,0
B550,0,0,0,0,0
B556,0,0,0,7,7
B557,0,0,0,0,0
B582,0,0,0,0,0
B583,0,0,0,0,0
B586,0,0,0,0,0
M377,0,77,0,1,78
M400,0,0,0,0,0
Q503,0,0,0,0,0
R137A,0,0,0,0,0
X357,0,0,0,0,0
X297,0,0,0,0,0
X293,0,0,0,0,0
X298,0,0,0,0,0
M341,0,0,0,0,0
B522,0,0,0,0,0
B399,0,0,0,0,0
X306,0,0,0,0,0
X150D,0,0,0,0,0
M329,5,0,0,35,40
X316,0,0,0,0,0
Q488,0,0,0,0,0
Q489,0,0,0,0,0
B415,0,0,0,0,0
B436,0,0,0,0,0
B468,0,0,0,0,0
B469,0,0,0,0,0
B428,0,0,0,0,0
B552,0,0,0,0,0
B470,0,0,0,0,0
R150,0,0,0,0,0
R141,0,0,0,0,0
X276,0,0,5,0,5
B471,0,0,0,0,0
M311,5,0,0,0,5
B486,0,0,0,0,0
B472,0,0,0,0,0
B484,0,0,0,0,0
B574,0,0,0,0,0
B575,0,0,0,0,0
B473,0,0,0,0,0
M131,308,2094,1044,2620,6066
X118A,56,1430,0,0,1486
M409,0,0,0,0,0
M271A,50,0,0,0,50
M363,0,0,0,0,0
M407,0,0,0,0,0
M322,0,0,0,0,0
B474,0,0,0,0,0
B400,10,30,0,60,100
B572,0,0,0,0,0
X364,0,0,0,0,0
M092A,0,0,0,0,0
B433,79,179,98,238,594
M406,0,0,0,0,0
B567,0,0,0,0,0
B475,0,0,0,0,0
R160,0,103,0,0,103
X270,0,0,0,0,0
X241,0,0,0,0,0
Q454,0,40,0,0,40
B512,0,0,0,0,0
M371,5,0,0,0,5
B528,0,0,0,0,0
B260A,366,0,0,1253,1619
M399,0,0,0,0,0
R131,0,0,0,0,0
B413,0,0,0,0,0
M344,0,0,0,0,0
B408,0,0,0,0,0
R136,0,0,0,0,0
B579,0,0,0,0,0
B565,0,0,0,0,0
X314,0,0,0,0,0
R151,0,258,0,387,645
M364,0,0,0,0,0
Q083,0,0,0,0,0
X319,0,77,0,26,103
Q309,0,28,0,0,28
Q506,0,0,0,0,0
M390,0,0,0,168,168
X320,0,0,0,112,112
X349,0,0,0,0,0
X322,0,0,0,0,0
B580,0,0,0,0,0
M278,0,0,0,0,0
B477,0,0,0,0,0
B478,0,0,0,0,0
B511,0,0,0,0,0
R146,0,0,0,0,0
B509,0,0,0,0,0
M351,0,0,0,0,0
M345,5,0,0,0,5
R138,0,0,0,0,0
X250,0,0,0,0,0
B351,6472,4758,24408,17059,52697
B398,0,0,0,0,0
M383,0,0,0,0,0
X145,0,0,0,0,0
X327,0,0,0,0,0
M373,0,0,0,0,0
M325,5,77,0,60,142
Q393B,0,0,0,0,0
X328,0,0,0,0,0
R148,0,0,0,0,0
X337,0,0,0,0,0
X355,0,0,0,0,0
B479,0,0,0,0,0
B223U,831,0,84,37,952
Q497,0,115,92,203,410
X365,0,0,0,0,0
M346,0,0,103,0,103
M232,0,0,0,0,0
B480,0,0,0,0,0
X356,0,0,0,0,0
M326,5,0,0,0,5
Q490,0,0,0,0,0
X310,0,0,0,0,0
R027,0,187,0,0,187
X290,175,94,0,0,269
M357,5,0,0,0,5
B112,0,0,0,0,0
B336A,0,0,0,0,0
X254,0,0,0,0,0
Q468,0,0,14,0,14
M108A,197,0,28,76,301
B498,0,0,0,0,0
M361,21,0,0,0,21
Q063,81,0,0,0,81
B499,0,0,0,0,0
B481,0,0,0,0,0
B482,0,0,0,0,0
M401,0,0,0,0,0
B483,0,0,0,0,0
R166,0,0,0,0,0
X236,1987,703,1281,34070,38041
B510,0,0,0,0,0
M297A,0,0,0,0,0
R142,0,0,0,0,0
B092,0,0,0,0,0
Q493,0,0,0,0,0
X353,0,0,0,0,0
Q096C,0,0,0,0,0
M318,0,263,1324,39,1626
R163,0,0,0,0,0
B085,384,9787,16596,1652,28419
Q069,40,89,0,0,129
M209,0,0,0,0,0
M314,5,0,0,0,5
X329,0,0,0,0,0
M347,0,0,0,0,0
X342,0,0,0,0,0
B584,0,0,0,0,0
M348,0,0,0,0,0
X275,0,39,0,26,65
Q130,0,0,0,257,257
X035,0,0,42,0,42
B521,0,0,0,0,0
B514,0,0,0,0,0
B540,0,0,0,0,0
M338,0,0,0,0,0
B280,0,0,0,0,0
M349,0,0,0,0,0
B449,0,0,0,0,0
X308,0,0,0,0,0
M393,0,0,0,0,0
R149,13136,39980,26920,16080,96116
M320,0,0,5,0,5
B434,0,66725,1081,84,67890
R159,0,0,0,0,0
R162,0,0,282,5,287
M354,5,77,0,35,117
M365,0,0,0,0,0
B442,0,0,0,0,0
X330,0,0,0,0,0
X354,30,314,67,245,656
B417,0,0,0,0,0
B485,0,0,0,0,0
M356,0,0,0,0,0
X285,0,0,0,0,0
B406,0,0,0,21,21
B558,0,0,0,0,0
X294,0,0,0,0,0
B210D,0,0,0,0,0
B210Q,0,387,54,0,441
B210R,0,0,0,0,0
B210S,0,0,0,0,0
B210T,0,0,0,0,0
B210U,0,0,0,0,0
B210V,0,0,0,0,0
B210L,0,0,0,0,0
B210M,0,0,0,0,0
B210N,0,0,0,0,0
B210O,0,0,0,0,0
B223C,0,0,0,0,0
B223IC,0,0,0,0,0
B223JA,0,0,0,0,0
B223OA,0,0,0,0,0
B255A,0,0,0,0,0
B255B,0,0,0,0,0
B255I,0,0,0,0,0
B537,0,0,0,0,0
B541,0,0,0,0,0
B547,0,0,0,0,0
B548,0,0,0,0,0
B587,0,0,0,0,0
B523,0,0,0,0,0
M108J,0,0,0,0,0
M092B,0,0,0,0,0
M108B,0,0,0,0,0
M262,0,77,0,77,154
M271B,0,0,0,0,0
Q220A,0,0,0,0,0
Q156,0,0,0,0,0
Q162H01,0,0,0,60,60
Q162I,0,0,0,0,0
Q096G,0,0,0,0,0
Q387C,0,0,0,0,0
Q360V,0,0,0,0,0
Q360W,0,0,0,0,0
Q360X,0,0,0,0,0
Q360Y1,0,0,0,0,0
Q360Y2,0,0,0,0,0
Q417,0,0,0,0,0
Q409,0,0,0,0,0
Q341A,0,0,0,0,0
Q360L,0,0,0,0,0
Q360I,0,0,0,0,0
Q360A,0,0,0,0,0
Q360C,0,0,0,0,0
Q360D,0,0,0,0,0
Q357A,0,0,0,0,0
Q357A1,0,0,0,0,0
Q357D,0,0,0,0,0
Q357E,0,0,0,0,0
Q357F,0,0,0,0,0
R044,0,0,0,0,0
R038B,0,0,0,0,0
Q500,0,0,0,0,0
Q504,67,0,0,134,201
Q508,0,0,0,0,0
Q509,0,0,0,0,0
Q433A,0,0,0,0,0
Q433B,0,0,0,0,0
R168,0,0,0,0,0
R075E,0,0,0,0,0
R075F,0,0,0,0,0
R096,0,0,0,0,0
R094,0,0,0,0,0
R098,0,0,0,0,0
R102,0,0,0,0,0
R103,0,0,0,0,0
X148J,0,0,0,0,0
X148H3,0,0,0,0,0
X148I,0,0,0,0,0
X148I2,0,0,0,0,0
X150K,0,0,0,616,616
X150M,0,0,0,0,0
X148C,0,0,0,0,0
X148E1,0,0,0,0,0
X148F1,1942,0,0,0,1942
X148F2,110,1518,0,0,1628
X148F3,0,0,0,0,0
X148F4,0,0,0,56,56
X148F5,0,0,0,0,0
X148G,0,0,0,0,0
X148G1,0,0,0,0,0
X148G2,0,0,0,0,0
X148A4,0,0,0,0,0
X148B,0,0,0,0,0
X148B1,0,59,0,0,59
X148A,0,0,0,0,0
X148A1,0,0,0,0,0
X303,0,0,0,0,0
X301,0,0,0,0,0
X225,0,0,0,0,0
X226,0,0,0,0,0
X191D,0,0,0,0,0
X195B,0,0,0,0,0
X195C,0,0,0,0,0
X195D,0,0,0,0,0
X195E,0,0,0,0,0
X195F,0,0,0,0,0
Q496,0,0,28,0,28
M060A,0,0,0,0,0
M060B,48,0,0,0,48
Q360P,0,0,0,0,0
M297,0,0,0,0,0
B573,0,0,0,0,0
B500,0,0,0,0,0
M367,0,4,0,0,4
M350,5,142,0,52,199
M167,0,0,0,0,0
M290,0,0,0,0,0
M369,0,0,0,0,0
B560,0,0,0,0,0
M375,0,0,0,0,0
M299,0,0,0,0,0
B504,0,0,0,0,0
B564,0,0,0,0,0
B516,0,0,0,0,0
R122,0,0,0,0,0
B570,0,0,0,0,0
B487,0,0,0,0,0
Q475,7,227,0,0,234
B423,0,52,0,77,129
B506,0,0,0,0,0
Q482,0,26,0,0,26
B524,0,0,0,0,0
M384,0,0,0,0,0
X317,0,0,0,0,0
M130,0,731,610,258,1599
B488,0,0,0,0,0
B489,0,0,0,0,0
Q480,126,0,292,0,418
M316,0,0,0,0,0
R154,0,0,0,0,0
R134,0,0,0,0,0
R167,0,0,0,0,0
X335,137,56,42,0,235
X245,0,0,0,0,0
Q455,9862,3425,2723,1999,18009
M073,1872,3880,7837,1133,14722
Q502,503,28,0,56,587
B490,0,0,0,0,0
B578,0,0,0,0,0
B517,0,0,0,0,0
R130,0,0,0,0,0
X332,0,0,0,0,0
Q469,0,0,0,0,0
Q501,0,0,4940,1016,5956
B094,0,0,0,0,0
B096,0,5,0,0,5
B476,0,0,0,0,0
B393,1469,889,0,2471,4829
B491,0,0,0,0,0
B502,0,0,0,0,0
R128,0,0,0,0,0
M408,0,0,0,0,0
R157,0,0,0,0,0
R116,892,267,186,0,1345
Q446,2526,13,4109,1070,7718
R147,0,0,0,0,0
B559,0,0,0,0,0
X309,0,0,0,0,0
R155,0,0,0,0,0
R104,0,0,0,0,0
Q481,83,0,0,0,83
Q473,1831,28,0,82,1941
B519,0,0,0,0,0
R075D,0,0,0,30,30
B165,98,0,0,0,98
B165A,0,0,0,0,0
B371,350,423,0,531,1304
Q165,0,0,0,507,507
X345,0,0,0,0,0
R077,0,0,0,0,0
B492,0,0,0,0,0
B501,0,0,0,0,0
M389,0,0,0,0,0
Q174,114,258,965,324,1661
B425,0,0,0,0,0
B426,0,0,0,0,0
M394,0,0,0,0,0
R170,0,0,0,26,26
B503,0,0,0,0,0
R143,0,0,0,0,0
B505,0,0,0,0,0
B563,0,0,0,0,0
B383,114,0,0,0,114
M319A,0,0,0,0,0
B411,0,0,0,0,0
B525,0,0,0,0,0
Q498,0,98,0,0,98
B427,0,0,0,0,0
B562,0,0,0,0,0
M108R,0,150,4,77,231
R156,0,279,0,258,537
X361,0,0,0,0,0
X296,0,0,0,0,0
R164,0,0,0,0,0
X325,0,0,0,0,0
B445,0,0,0,0,0
B409,0,0,0,0,0
B410,0,0,0,0,0
M315,5,0,0,0,5
B368,0,0,0,0,0
B546,0,0,0,0,0
M276,0,0,917,76,993
M332,5,0,0,0,5
X050,0,0,0,0,0
Q479,0,0,0,0,0
X304,0,0,0,0,0
B416,0,0,0,0,0
M103,4145,968,2239,1969,9321
R139,0,0,0,117,117
X331,0,0,0,0,0
X148C4,0,0,0,0,0
B576,0,0,0,0,0
M366,0,103,0,578,681
Q066D,0,0,0,0,0
Q066E,0,0,0,0,0
M387,0,0,0,0,0
Q477,0,181,0,211,392
B420,0,0,0,0,0
M380,0,0,0,0,0
B515,0,0,0,0,0
B527,0,0,0,0,0
B513,0,0,0,0,0
X277A,0,0,0,0,0
M298,0,0,0,0,0
B493,0,0,0,0,0
M370,5,0,0,0,5
X215,0,15,0,0,15
M343,5,0,0,0,5
Q472,0,0,0,0,0
B508,0,0,0,0,0
B494,0,0,0,0,0
B495,0,0,0,0,0
B496,0,0,0,0,0
B518,0,0,0,0,0
B551,0,0,0,9,9
M182,0,0,0,0,0
X347,0,0,0,0,0
X346,0,0,0,0,0
M306,0,0,0,0,0
M362,0,0,0,0,0
M307,0,0,0,0,0
M405,0,0,0,0,0
B456,0,0,0,0,0
M403,0,0,0,0,0
X148D,0,0,35,0,35
X148C6,0,0,0,0,0
B581,0,0,0,0,0
X088A,0,0,0,0,0
X209,0,0,0,0,0
B538,0,0,0,0,0
M368,0,103,0,17,120
X311,0,0,0,0,0
M328,0,0,0,0,0
Q121A,0,0,0,1069,1069
Q507,0,0,0,0,0
X333,0,0,0,0,0
X237,0,0,0,0,0
M352,5,0,0,0,5
R161,25,20,9,12,66
XZ307,10,17,20,19,66
MZ156,23,19,23,0,65
QZ294,6,23,13,23,65
RZ21,17,15,18,15,65
XZ274,23,16,14,12,65
XZ335,12,16,22,15,65
Q214,8,12,14,30,64
QZ117,3,3,21,37,64
QZ763,8,48,8,0,64
XZ212,17,17,12,18,64
XZ213,17,18,12,17,64
XZ264,19,12,17,16,64
QZ79,6,12,5,40,63
R077,28,35,0,0,63
XZ266,25,15,12,11,63
XZ374,21,22,9,11,63
M052,39,6,13,4,62
MZ09,9,8,34,11,62
MZ436,15,10,21,16,62
QZ51,0,20,19,23,62
RZ013B,15,17,16,14,62
RZ013D,15,17,16,14,62
RZ013E,15,17,16,14,62
X110B,18,12,20,12,62
XZ214,16,14,13,19,62
XZ362,17,14,14,17,62
XZ60,18,14,15,15,62
BZ128,30,11,12,8,61
BZ527,5,22,20,14,61
BZ68,4,6,18,33,61
MZ180,14,21,15,11,61
Q160,12,14,20,15,61
Q246,10,14,8,29,61
RZ133,8,31,9,13,61
XZ123,13,14,17,17,61
XZ36,17,14,12,18,61
XZ99,10,15,11,25,61
BZ12,13,12,20,15,60
M291,15,13,20,12,60
Q070,15,14,19,12,60
Q116,10,20,16,14,60
QZ110,19,13,12,16,60
QZ300,13,14,18,15,60
QZ444,10,15,22,13,60
QZ445,10,15,22,13,60
R003,0,0,29,31,60
XZ147,13,19,16,12,60
XZ50,15,15,13,17,60
XZ65B,20,10,8,22,60
B030,25,15,11,8,59
BZ258,27,12,10,10,59
BZ262,18,15,15,11,59
MZ409,0,59,0,0,59
QZ726,5,5,18,31,59
BZ26,19,16,14,9,58
BZ349,18,15,14,11,58
BZ424,23,9,14,12,58
BZ99,10,9,21,18,58
MZ457,8,2,27,21,58
QZ183,6,22,15,15,58
QZ903,6,15,23,14,58
XZ37,13,14,12,19,58
XZ455,15,8,23,12,58
B394,0,10,29,18,57
BZ44,35,6,8,8,57
BZ52,31,9,10,7,57
MZ195,23,19,15,0,57
MZ459,14,13,20,10,57
QZ607,12,12,15,18,57
RZ119,23,10,8,16,57
XZ275,9,13,13,22,57
XZ280,10,13,12,22,57
XZ304,19,15,13,10,57
XZ491,16,13,15,13,57
BZ150,16,19,14,7,56
Q056,7,14,17,18,56
QZ455,15,14,19,8,56
QZ510,8,21,15,12,56
X070,20,8,9,19,56
XZ333,10,15,19,12,56
XZ35,13,14,13,16,56
XZ65C,26,10,8,12,56
BZ130,20,8,18,9,55
BZ153,23,11,12,9,55
BZ367,21,15,8,11,55
BZ489,26,7,13,9,55
BZ72,26,13,11,5,55
Q075,9,13,10,23,55
Q254,15,9,14,17,55
Q360R,15,5,10,25,55
QZ182,7,19,17,12,55
QZ293,12,17,14,12,55
QZ454,15,12,19,9,55
XZ15,19,8,12,16,55
XZ284,10,16,15,14,55
XZ480,15,13,14,13,55
BZ264,14,13,13,14,54
MZ432,54,0,0,0,54
Q140,18,10,16,10,54
Q504,16,16,14,8,54
RZ161,7,15,18,14,54
X364,0,0,0,54,54
XZ265,12,13,16,13,54
XZ356,17,10,10,17,54
BZ23,15,17,12,9,53
BZ373,11,6,23,13,53
BZ47,16,15,12,10,53
X110C,12,14,20,7,53
XZ27,12,14,14,13,53
XZ272,45,0,0,8,53
XZ42,10,9,17,17,53
BZ344,0,8,24,20,52
BZ345,0,9,22,21,52
BZ371,19,15,8,10,52
M231,15,13,15,9,52
QZ744,27,19,3,3,52
RZ122,26,8,7,11,52
RZ124,25,14,7,6,52
XZ40,12,19,17,4,52
BZ242,20,14,8,9,51
BZ276,15,14,9,13,51
BZ370,19,14,9,9,51
BZ38,11,10,11,19,51
BZ97,14,14,10,13,51
M345,0,0,51,0,51
QZ352,2,19,5,25,51
QZ519,5,19,15,12,51
X209,0,0,33,18,51
XZ34,9,15,13,14,51
BZ282,11,12,15,12,50
BZ287,11,11,20,8,50
BZ309,17,11,15,7,50
BZ360,24,12,14,0,50
BZ490,23,8,10,9,50
BZ98,15,12,11,12,50
Q208,15,11,13,11,50
Q387B,20,16,6,8,50
QZ299,13,14,12,11,50
QZ363,0,15,12,23,50
RZ31,5,32,7,6,50
X333,0,0,50,0,50
XZ286,10,17,11,12,50
XZ436,13,13,14,10,50
XZ49,14,12,15,9,50
B278,13,7,14,15,49
BZ11,14,11,7,17,49
BZ315,16,10,9,14,49
BZ488,19,13,9,8,49
QZ151,8,14,16,11,49
QZ153,1,13,5,30,49
QZ189,26,12,6,5,49
QZ275,16,11,13,9,49
QZ298,10,13,15,11,49
QZ632,21,7,7,14,49
RZ123,27,6,8,8,49
BZ161,9,10,15,14,48
BZ246,9,12,18,9,48
BZ58,23,11,7,7,48
BZ74,29,7,3,9,48
QZ296,7,14,15,12,48
BZ208,0,46,0,1,47
BZ278,8,11,17,11,47
BZ95,2,10,26,9,47
M060B,21,2,1,23,47
MZG001,19,16,12,0,47
QZ114,13,15,10,9,47
QZ762,10,11,14,12,47
QZ795,21,12,8,6,47
R057,23,10,8,6,47
X148A,4,11,12,20,47
XZ129,32,7,4,4,47
BZ228,16,8,16,6,46
BZ247,9,9,9,19,46
BZ267,10,16,10,10,46
BZ35,9,11,15,11,46
BZ71,8,13,16,9,46
M232,0,46,0,0,46
QZ131,14,8,12,12,46
QZ150,7,6,4,29,46
QZ285,0,12,11,23,46
QZ443,11,11,15,9,46
QZ667,24,16,2,4,46
XZ178,12,7,13,14,46
XZ57,11,10,16,9,46
BZ17,24,9,7,5,45
BZ261,13,13,13,6,45
Q084B,4,23,8,10,45
Q283,6,5,17,17,45
Q383,8,13,9,15,45
RZG006,0,14,22,9,45
XZ277,7,12,14,12,45
XZ285,15,10,9,11,45
XZ380,15,9,6,15,45
XZ58,18,9,12,6,45
BZ219,16,8,10,10,44
QZ276,13,13,10,8,44
QZ280,13,13,10,8,44
QZ281,14,14,9,7,44
QZ284,0,14,10,20,44
QZ46A,8,10,7,19,44
QZ473,18,11,4,11,44
XZ342,3,10,13,18,44
XZ344,3,11,12,18,44
BZ274,21,6,6,10,43
BZ36,14,7,10,12,43
BZ45,7,18,10,8,43
Q441,5,13,14,11,43
QZ147,4,6,4,29,43
QZ196,17,12,9,5,43
QZ278,13,13,9,8,43
QZ626,19,0,24,0,43
QZ942,2,30,5,6,43
XZ490,8,16,7,12,43
BZ235,20,9,6,7,42
BZ307,21,6,9,6,42
BZ59,15,12,6,9,42
BZ85,10,7,15,10,42
MZ308,7,11,13,11,42
QZ297,11,10,11,10,42
QZ392,5,8,20,9,42
QZ727,4,5,3,30,42
RZ120,12,10,6,14,42
RZ56,7,14,11,10,42
X285,0,27,15,0,42
XZ177,13,5,10,14,42
XZ470,12,9,9,12,42
XZ65D,12,8,5,17,42
BZ201,5,6,13,17,41
BZ53,11,11,9,10,41
MZ464,41,0,0,0,41
QT12,10,8,10,13,41
BZ08,7,7,18,8,40
BZ126,20,10,6,4,40
BZ151,19,10,6,5,40
BZ316,12,15,7,6,40
BZ523,6,13,13,8,40
QZ208,21,8,6,5,40
QZ77,10,10,16,4,40
QZ954,17,10,6,7,40
X052,4,5,17,14,40
XZ343,3,9,14,14,40
XZ373,15,4,8,13,40
XZ52,8,12,9,11,40
BZ114,6,5,18,10,39
BZ170,0,11,20,8,39
BZ171,11,0,19,9,39
BZ18,22,5,8,4,39
BZ281,5,13,9,12,39
BZ46,15,8,11,5,39
MZ456,8,2,26,3,39
QZ295,5,11,11,12,39
QZ31,29,2,4,4,39
QZ596,12,6,11,10,39
QZ902,18,7,7,7,39
QZ904,9,10,9,11,39
RZ104,3,4,28,4,39
RZ121,10,10,6,13,39
RZ14,5,20,5,9,39
X148B1,17,6,9,7,39
XZ235,0,6,19,14,39
XZ433,10,11,6,12,39
XZ94,13,9,11,6,39
BU002,38,0,0,0,38
BZ22,10,10,13,5,38
BZ289,18,10,7,3,38
BZ376,5,10,13,10,38
BZ62,9,12,10,7,38
MZ289,0,0,38,0,38
QZ101,26,0,0,12,38
R027,3,6,29,0,38
X148A1,11,14,12,1,38
X150M,4,17,14,3,38
XZ392,6,9,8,15,38
XZ476,10,10,7,11,38
XZ63,9,10,6,13,38
BZ21,10,10,12,5,37
BZ37,14,4,12,7,37
BZ375,13,11,5,8,37
BZ455,22,4,8,3,37
BZ60,14,8,9,6,37
MZ455,8,2,22,5,37
QZ543,4,0,3,30,37
QZ57,3,11,4,19,37
QZ591,9,7,10,11,37
QZ737,3,10,2,22,37
QZ78,12,9,11,5,37
QZ86,9,10,10,8,37
R099,15,11,5,6,37
RZ156,6,21,5,5,37
RZ159,6,21,5,5,37
RZ74,7,22,3,5,37
X148F5,0,0,0,37,37
XZ269,11,7,12,7,37
B223MA,9,7,14,6,36
B276,9,7,13,7,36
BZ179,24,0,12,0,36
BZ253,19,9,5,3,36
BZ270,12,7,8,9,36
BZ272,11,7,10,8,36
BZ48,9,6,16,5,36
BZ81,10,6,6,14,36
MZ16,0,31,3,2,36
Q213,6,5,11,14,36
QZ348,2,10,6,18,36
QZ48,0,13,11,12,36
QZ486,16,8,3,9,36
QZ504,0,14,11,11,36
QZ505,0,14,11,11,36
QZ506,0,14,11,11,36
QZ59,12,8,11,5,36
QZ605,7,7,8,14,36
R132,7,9,16,4,36
RZ163,6,21,4,5,36
XZ481,7,11,6,12,36
BZ160,8,7,12,8,35
BZ243,7,11,8,9,35
BZ263,15,9,6,5,35
BZ369,9,7,11,8,35
BZ423,0,8,16,11,35
BZ564,23,4,4,4,35
BZ568,17,10,4,4,35
BZ61,14,8,6,7,35
QZ1012,9,5,11,10,35
QZ364,3,10,6,16,35
QZ503,0,14,11,10,35
QZ622,9,6,9,11,35
QZ953,0,0,0,35,35
R101,10,8,11,6,35
RZ320,0,4,23,8,35
X304,35,0,0,0,35
XZ06,15,5,8,7,35
XZ76,7,11,8,9,35
BZ140,8,8,11,7,34
BZ159,9,8,11,6,34
BZ266,13,8,7,6,34
BZ29,6,7,6,15,34
BZ441,9,8,9,8,34
BZ51,13,8,8,5,34
Q135A,2,3,8,21,34
QZ193,15,11,5,3,34
QZ209,17,7,5,5,34
QZ355,2,4,12,16,34
QZ863,29,5,0,0,34
XZ14,3,5,13,13,34
XZ205,2,10,10,12,34
XZ457,12,9,9,4,34
XZ458,25,4,5,0,34
XZ56B,8,7,11,8,34
BZ110,20,4,7,2,33
BZ202,8,10,8,7,33
BZ213,32,0,0,1,33
BZ251,10,10,7,6,33
BZ374,11,9,7,6,33
BZ39,12,7,5,9,33
M348,0,0,11,22,33
MZ450,6,6,18,3,33
Q168,2,7,3,21,33
Q360L,0,33,0,0,33
QZ104,8,5,11,9,33
QZ283,7,11,8,7,33
QZ538,0,3,4,26,33
QZ606,6,6,7,14,33
RZ193,5,14,5,9,33
RZ72,4,22,3,4,33
XZ127,15,7,6,5,33
XZ130,15,11,4,3,33
XZ38,8,8,9,8,33
BZ220,15,5,7,5,32
BZ283,8,8,10,6,32
BZ93A,0,7,10,15,32
BZ93B,0,8,9,15,32
QZ349,1,12,4,15,32
QZ767,7,10,9,6,32
QZ872,0,0,6,26,32
QZ926,16,11,2,3,32
R098,16,5,5,6,32
X215,0,2,30,0,32
XZ393,6,9,7,10,32
XZ56A,7,8,9,8,32
XZ97,32,0,0,0,32
BZ03,11,4,9,7,31
Q224,12,3,4,12,31
Q497,0,0,0,31,31
QZ861,5,26,0,0,31
R131,3,8,18,2,31
X148F2,5,2,0,24,31
XZ51,4,7,11,9,31
B031,13,5,4,8,30
B378,10,3,11,6,30
BZ284,8,7,10,5,30
BZ30,10,7,5,8,30
BZ359,8,9,6,7,30
BZ378,2,13,6,9,30
BZ394,9,3,11,7,30
BZ418,0,6,16,8,30
BZ591,14,4,7,5,30
QZ107,15,4,5,6,30
QZ116,3,3,9,15,30
QZ140,6,8,9,7,30
QZ194,19,7,4,0,30
QZ282,6,11,7,6,30
QZ325,3,4,6,17,30
QZ552,8,4,4,14,30
QZ70,6,3,5,16,30
QZ71,3,2,5,20,30
QZ732,3,9,2,16,30
QZ781,8,9,6,7,30
QZ995,9,0,0,21,30
RZ333,8,8,6,8,30
X118A,0,0,0,30,30
XZ142,6,10,6,8,30
XZ381,6,8,6,10,30
XZ448,7,9,7,7,30
XZ62,8,9,6,7,30
BZ232,19,2,4,4,29
BZ237,12,7,3,7,29
BZ33,9,8,5,7,29
BZ377,5,7,6,11,29
BZ565,12,9,4,4,29
BZ87,3,11,5,10,29
MZ19,21,0,8,0,29
QZ141,7,7,8,7,29
QZ279,5,10,8,6,29
QZ350,1,10,4,14,29
QZ584,8,4,9,8,29
QZ590,5,5,10,9,29
QZG004,10,9,10,0,29
RZ323,7,9,6,7,29
X148F1,0,12,11,6,29
XZ118,8,5,6,10,29
XZ394,7,8,7,7,29
XZ66,10,7,6,6,29
BZ141,10,5,8,5,28
BZ214,10,5,8,5,28
BZ238,11,6,4,7,28
BZ240,10,5,4,9,28
BZ556,0,22,0,6,28
BZ57,15,4,5,4,28
BZ77,13,5,6,4,28
MZ98,0,0,16,12,28
Q043,11,7,5,5,28
QZ361,3,2,5,18,28
QZ470,9,6,2,11,28
QZ643,8,5,8,7,28
QZ993,20,3,2,3,28
QZ994,20,3,2,3,28
R075F,24,0,4,0,28
RZ45,5,7,8,8,28
RZ82,8,7,7,6,28
X350,0,0,0,28,28
XZ208,7,6,9,6,28
BS17,0,27,0,0,27
BZ231,15,2,6,4,27
BZ298,4,3,13,7,27
BZ32,8,5,7,7,27
BZ393,0,9,6,12,27
BZ50,12,6,6,3,27
BZ539,0,27,0,0,27
BZ567,13,6,4,4,27
BZ587,12,4,6,5,27
MZ274,27,0,0,0,27
MZ325,4,7,7,9,27
QZ448,8,5,9,5,27
QZ453,8,7,6,6,27
QZ496,0,8,9,10,27
R096,23,2,1,1,27
RZ148,8,6,6,7,27
RZ54,5,14,5,3,27
XZ197,4,10,9,4,27
B223DF,0,0,26,0,26
B414,0,0,9,17,26
BZ162,11,4,4,7,26
BZ327,8,3,7,8,26
BZ580,8,5,6,7,26
MZ324,4,8,7,7,26
Q325,10,6,5,5,26
Q387D,5,5,9,7,26
QZ100,8,4,9,5,26
QZ39,11,6,4,5,26
QZ500,0,8,9,9,26
QZ608,4,4,9,9,26
QZ610,5,3,7,11,26
R094,17,5,2,2,26
RZ223,9,6,7,4,26
RZ82A,8,7,7,4,26
BZ241,11,3,4,7,25
BZ275,11,5,5,4,25
BZ297,8,5,7,5,25
BZ321,15,2,3,5,25
BZ425,0,8,7,10,25
BZ426,0,10,4,11,25
BZ83,11,5,5,4,25
QZ149,3,4,10,8,25
QZ497,0,8,9,8,25
QZ498,0,8,9,8,25
QZ499,0,8,9,8,25
QZ501,0,8,9,8,25
QZ609,5,4,7,9,25
RZ076S,4,12,4,5,25
RZ325,7,9,3,6,25
BZ322,13,3,3,5,24
BZ588,10,3,6,5,24
BZ88,3,9,8,4,24
MZ205,6,2,16,0,24
QZ124,7,4,8,5,24
QZ277,10,8,2,4,24
QZ457,5,5,9,5,24
QZ598,9,4,3,8,24
RZ322,5,7,6,6,24
RZ38,20,2,1,1,24
BZ301,6,5,5,7,23
BZ343,12,3,3,5,23
BZ492,0,6,6,11,23
BZ589,8,3,7,5,23
BZ590,7,4,7,5,23
BZ69,12,5,4,2,23
MZ322,4,7,6,6,23
MZ323,4,7,6,6,23
QZ15,8,5,5,5,23
QZ366,6,3,6,8,23
QZ421,3,5,10,5,23
QZ559,0,0,19,4,23
QZ560,0,0,19,4,23
QZ604,5,5,4,9,23
QZ740,6,5,8,4,23
QZ974,0,0,23,0,23
QZ996,23,0,0,0,23
RZ126,3,13,3,4,23
RZ127,3,13,3,4,23
RZ128,3,13,3,4,23
RZ244,8,4,5,6,23
RZ321,5,7,6,5,23
X148G2,0,1,0,22,23
B210T,0,0,0,22,22
B223C,7,6,5,4,22
BZ173,8,4,4,6,22
BZ338,5,3,6,8,22
BZ563,0,5,6,11,22
BZ91,4,5,8,5,22
M319B,0,0,0,22,22
MZ451,5,9,5,3,22
Q159,7,3,8,4,22
Q360Y1,0,22,0,0,22
QZ1004,0,0,0,22,22
QZ53,9,3,5,5,22
QZ583,5,4,8,5,22
QZ601,10,3,4,5,22
QZ925,10,8,1,3,22
X245,0,0,0,22,22
X279,15,0,0,7,22
XZ121C,5,8,6,3,22
XZ240,3,4,9,6,22
BZ257,8,5,4,4,21
BZ336,9,3,5,4,21
BZ340,5,3,6,7,21
BZ562,0,5,5,11,21
BZ65,7,5,4,5,21
QZ393,3,5,9,4,21
QZ411,3,5,8,5,21
QZ551,21,0,0,0,21
QZ922,10,7,1,3,21
QZ924,10,7,1,3,21
R130,5,6,6,4,21
RZ06,5,4,6,6,21
RZ076N,4,9,4,4,21
RZ241,16,3,1,1,21
RZ318,5,7,4,5,21
XZ379,7,5,6,3,21
XZ467,0,9,7,5,21
BZ223,6,7,5,2,20
BZ326,5,3,7,5,20
BZ566,8,4,4,4,20
QZ319,6,3,6,5,20
QZ537,12,3,5,0,20
QZ600,4,4,6,6,20
QZ602,5,4,5,6,20
QZ68,9,3,4,4,20
QZ921,10,7,1,2,20
QZ923,10,7,1,2,20
QZG001,9,11,0,0,20
RZ157,5,5,6,4,20
X148A4,0,0,0,20,20
XZ239,3,4,9,4,20
XZ337,7,4,5,4,20
XZ340,3,8,5,4,20
BZ299,4,4,4,7,19
BZ414,0,8,5,6,19
BZ415,0,5,8,6,19
BZ445,0,8,8,3,19
BZ456,0,9,6,4,19
M287,5,2,6,6,19
QZ163,3,3,7,6,19
QZ389,4,6,6,3,19
QZ533,6,3,5,5,19
QZ603,6,4,2,7,19
RZ180,6,4,4,5,19
RZ308,5,4,6,4,19
RZ57,4,5,5,5,19
RZ82N,5,6,5,3,19
RZ82S,5,6,5,3,19
XZ105,0,19,0,0,19
XZ128,3,5,4,7,19
XZ478,4,6,6,3,19
BZ176,4,3,7,4,18
BZ25,6,4,5,3,18
BZ339,5,3,5,5,18
BZ413,0,7,5,6,18
BZ416,0,4,8,6,18
BZ494,3,3,4,8,18
BZ508,0,7,7,4,18
MZ212,0,0,18,0,18
MZ453,5,6,4,3,18
QZ156,2,10,3,3,18
QZ424,2,3,10,3,18
QZ54,3,3,8,4,18
QZ623,4,3,7,4,18
QZ69,5,3,5,5,18
QZ745,0,0,0,18,18
QZ874,3,4,3,8,18
QZ931,12,6,0,0,18
RZ309,5,3,6,4,18
RZ75,5,4,4,5,18
X148H3,0,0,0,18,18
XZ271,0,0,18,0,18
XZ336,6,5,4,3,18
XZ339,7,4,4,3,18
BZ230,5,4,5,3,17
BZ244,5,3,4,5,17
BZ255,4,4,6,3,17
BZ330,3,3,5,6,17
BZ337,6,3,3,5,17
BZ457,0,7,6,4,17
BZ513,0,5,11,1,17
M108B,17,0,0,0,17
M130,10,3,4,0,17
M399,7,4,6,0,17
QZ146,5,3,6,3,17
QZ165,4,3,4,6,17
QZ286,0,0,6,11,17
QZ317,5,4,4,4,17
QZ516,12,2,1,2,17
R143,4,4,4,5,17
RZ176,5,5,4,3,17
RZ27,7,3,4,3,17
RZ51,5,3,5,4,17
XZ126,4,5,4,4,17
BZ200,7,2,3,4,16
BZ222,3,5,5,3,16
BZ227,5,3,5,3,16
BZ254,4,4,6,2,16
BZ323,7,2,4,3,16
BZ512,0,6,6,4,16
BZ54,3,1,5,7,16
MZ220,0,12,4,0,16
MZ395,3,13,0,0,16
QZ390,2,4,7,3,16
QZ518,10,2,2,2,16
QZ631,5,2,4,5,16
QZ644,4,2,7,3,16
QZ929,12,4,0,0,16
QZ930,12,4,0,0,16
R136,3,4,6,3,16
RZ101,4,5,4,3,16
RZ219,3,7,2,4,16
RZ222,4,4,4,4,16
RZ245,4,3,5,4,16
RZ25,5,4,4,3,16
RZ315,5,4,3,4,16
XZ106,0,0,2,14,16
B210R,14,0,1,0,15
BZ224,6,3,4,2,15
BZ225,4,4,4,3,15
BZ226,5,3,4,3,15
BZ256,5,3,5,2,15
BZ342,4,3,4,4,15
BZ421,0,6,4,5,15
BZ454,0,3,8,4,15
BZ510,0,5,6,4,15
BZ592,6,4,2,3,15
MZ452,4,5,3,3,15
Q172,12,0,3,0,15
QZ161,4,2,6,3,15
QZ162,4,3,5,3,15
QZ391,2,4,6,3,15
QZ746,2,2,7,4,15
QZ971,9,3,3,0,15
RZ10,8,5,1,1,15
RZ172,4,4,4,3,15
RZ175,4,3,3,5,15
RZ211,2,9,2,2,15
RZ217,2,9,2,2,15
RZ218,2,9,2,2,15
RZ220,3,7,2,3,15
RZ26,4,3,4,4,15
RZ67,10,1,1,3,15
RZ89,3,7,2,3,15
RZ93,3,7,2,3,15
RZ94,3,7,2,3,15
RZ95,3,7,2,3,15
X148G1,0,0,0,15,15
XZ125,3,4,5,3,15
XZ131,3,5,4,3,15
XZ132,3,4,5,3,15
BZ217,3,3,5,3,14
BZ324,6,2,3,3,14
BZ335,4,2,4,4,14
BZ341,4,2,4,4,14
BZ451,0,5,3,6,14
M313,0,0,0,14,14
M396,0,0,0,14,14
QZ471,5,4,3,2,14
QZ63,2,3,0,9,14
QZ988,6,7,1,0,14
R133,4,2,5,3,14
RZ166,4,3,4,3,14
RZ255,3,4,3,4,14
RZ40,5,3,3,3,14
RZ41,3,4,4,3,14
BZ245,6,2,2,3,13
BZ325,4,2,3,4,13
BZ422,0,6,3,4,13
BZ450,0,4,3,6,13
BZ551,13,0,0,0,13
Q360Y2,0,5,8,0,13
QZ32,5,2,3,3,13
QZ33,5,2,4,2,13
QZ408,1,3,5,4,13
QZ410,3,2,4,4,13
QZ725,4,2,3,4,13
RZ03,4,2,4,3,13
RZ115,3,4,3,3,13
RZ174,3,3,3,4,13
RZ192,3,3,4,3,13
RZ221,3,4,3,3,13
RZ23,4,3,4,2,13
RZ28,3,4,3,3,13
RZ32,3,3,3,4,13
RZ33,3,3,4,3,13
RZ36,4,3,2,4,13
RZ68,10,1,1,1,13
X246,0,0,13,0,13
XZ121B,4,5,1,3,13
BZ167,0,12,0,0,12
BZ449,0,5,2,5,12
BZ511,0,5,5,2,12
Q096C,0,0,12,0,12
QZ412,2,2,4,4,12
QZ422,2,2,5,3,12
QZ425,2,2,5,3,12
QZ512,8,2,1,1,12
QZ514,6,2,1,3,12
RZ012A,2,6,2,2,12
RZ012B,2,6,2,2,12
RZ012C,2,6,2,2,12
RZ012D,2,6,2,2,12
RZ012E,2,6,2,2,12
RZ012F,2,6,2,2,12
RZ24,3,3,3,3,12
RZ263,8,2,1,1,12
BZ300,4,1,3,3,11
BZ419,0,5,3,3,11
BZ420,0,5,3,3,11
Q096F,11,0,0,0,11
QT18,9,2,0,0,11
QZ1028,8,0,0,3,11
QZ127,2,2,4,3,11
QZ14,2,2,4,3,11
QZ27,3,3,3,2,11
QZ36A,2,3,3,3,11
QZ511,6,2,1,2,11
QZ513,6,2,1,2,11
QZ517,5,2,2,2,11
R104,0,6,5,0,11
RZ01,2,3,3,3,11
RZ277,3,3,2,3,11
RZ48,9,1,1,0,11
RZ62,3,3,3,2,11
XZ121A,3,4,1,3,11
B085,0,0,10,0,10
B210O,0,6,4,0,10
B223DG,0,0,10,0,10
BZ448,0,3,2,5,10
BZ547,0,0,0,10,10
MZ194,7,0,0,3,10
MZ449,10,0,0,0,10
Q152,0,2,0,8,10
QZ1024,2,0,0,8,10
QZ103,4,4,0,2,10
QZ13,2,2,4,2,10
QZ138,0,7,0,3,10
QZ155,2,1,4,3,10
QZ409,2,1,3,4,10
QZ515,5,2,1,2,10
RZ162,3,2,2,3,10
RZ20,3,2,2,3,10
RZ311,2,2,4,2,10
RZ327,2,3,3,2,10
RZ328,2,3,3,2,10
X140,0,0,0,10,10
B586,0,0,6,3,9
BZ216,0,0,0,9,9
BZ549,0,0,9,0,9
MZ155,0,0,9,0,9
Q357,0,0,0,9,9
QZ36B,2,2,3,2,9
QZ484,3,2,3,1,9
QZ736,3,3,1,2,9
QZ742,0,3,6,0,9
QZ960,0,0,9,0,9
R138,2,3,3,1,9
RZ183,3,2,2,2,9
RZ278,2,2,2,3,9
B210S,8,0,0,0,8
BZ63,4,1,1,2,8
M051,0,0,0,8,8
M113A,0,0,0,8,8
MZ398,8,0,0,0,8
MZ442,8,0,0,0,8
MZ448,8,0,0,0,8
Q482,2,6,0,0,8
QZ1025,0,0,0,8,8
QZ128,2,1,3,2,8
QZ735,3,2,1,2,8
RZ63,2,2,2,2,8
RZ69,1,3,1,3,8
X148C,0,7,0,1,8
X345,0,0,8,0,8
BZ07,0,0,7,0,7
BZ534,7,0,0,0,7
M131,0,0,7,0,7
MZ152,7,0,0,0,7
MZ201,7,0,0,0,7
QZ129,1,1,3,2,7
QZ873,1,1,3,2,7
QZ911,7,0,0,0,7
QZ943,4,3,0,0,7
RZ312,1,2,2,2,7
X148F4,0,7,0,0,7
X148G,0,0,0,7,7
BZ502,0,0,0,6,6
M320,0,0,0,6,6
M390,0,0,6,0,6
MZ203,3,3,0,0,6
MZ234,0,0,0,6,6
QZ1029,6,0,0,0,6
QZ1030,6,0,0,0,6
QZ160,2,1,2,1,6
QZ423,0,5,0,1,6
QZ485,2,1,2,1,6
QZ585,0,0,5,1,6
QZ586,0,0,5,1,6
QZ587,0,0,5,1,6
QZ588,0,0,5,1,6
QZ589,0,0,5,1,6
QZ968,0,6,0,0,6
R002,1,2,1,2,6
RZ179,2,1,2,1,6
RZ30,1,1,3,1,6
RZ35,1,1,1,3,6
M283,0,0,0,5,5
Q360A,0,5,0,0,5
Q360V,5,0,0,0,5
QZ1013,5,0,0,0,5
QZ467,2,1,1,1,5
QZ469,2,1,1,1,5
QZ483,2,1,1,1,5
R146,0,5,0,0,5
RZ271,1,2,1,1,5
RZ29,1,1,2,1,5
RZ326,1,1,2,1,5
X066,0,0,0,5,5
X148J1,0,0,0,5,5
B554,0,0,4,0,4
BZ446,0,0,4,0,4
M310,0,4,0,0,4
M321A,0,2,0,2,4
MZ18,0,0,0,4,4
MZ465,4,0,0,0,4
Q455,4,0,0,0,4
QZ468,1,1,1,1,4
R168,1,1,1,1,4
RZ042A,1,1,1,1,4
RZ042B,1,1,1,1,4
RZ107,1,1,1,1,4
RZ111,1,1,1,1,4
RZ15,1,1,1,1,4
RZ181,1,1,1,1,4
RZ258,1,1,1,1,4
RZ266,1,1,1,1,4
RZ267,1,1,1,1,4
RZ270,1,1,2,0,4
RZ313,1,1,1,1,4
RZ314,1,1,1,1,4
RZ317,1,1,1,1,4
RZ319,1,1,1,1,4
RZ324,1,1,1,1,4
RZ332,1,1,1,1,4
RZ39,1,1,1,1,4
RZ43,1,1,1,1,4
RZ47,1,1,1,1,4
RZ49,0,1,2,1,4
RZ70,1,1,1,1,4
X148I2,0,0,4,0,4
M361,0,0,0,3,3
MZ313,3,0,0,0,3
MZ443,3,0,0,0,3
MZ444,3,0,0,0,3
MZ454,0,0,3,0,3
Q500,3,0,0,0,3
QZ541,0,0,3,0,3
QZ542,0,0,3,0,3
QZ544,0,0,3,0,3
RZ167,3,0,0,0,3
RZ178,1,1,1,0,3
RZ259,0,0,3,0,3
RZ64,0,1,1,1,3
X331,0,0,0,3,3
X339,0,0,3,0,3
B477,0,0,2,0,2
MZ404,2,0,0,0,2
Q393B,0,0,0,2,2
QZ1017,0,0,0,2,2
QZ941,2,0,0,0,2
QZ961,2,0,0,0,2
R139,0,1,1,0,2
R155,0,0,2,0,2
RZ286,1,0,1,0,2
BZ209,0,0,0,1,1
BZ210,0,0,0,1,1
BZ211,0,0,0,1,1
M008,0,0,0,1,1
M108R,1,0,0,0,1
M325,0,1,0,0,1
M357,0,0,0,1,1
QZ574,0,0,0,1,1
QZ761,0,0,1,0,1
R137,0,0,1,0,1
RZ238,0,0,1,0,1
RZ268,1,0,0,0,1
X148B,1,0,0,0,1
B048,0,0,0,0,0
B336A,0,0,0,0,0
M032,0,0,0,0,0
M036,0,0,0,0,0
M101,0,0,0,0,0
R152,0,0,0,0,0
